si'xna	(en) s ɪ k s n ə (el)
'pada	(en) p ɑ d ə (el)
'etimos	(en) ɛ t ɪ m əʊ z (el)
stama'tao	(en) s t a m ɐ t aʊ (el)
'pavo	(en) p ɑ v əʊ (el)
teli'ono	(en) t ɛ l ɪ  əʊ n əʊ (el)
'telos	(en) t i l əʊ z (el)
ðiar'ko	(en) ð aɪə k əʊ (el)
ar'xizo	(en) ɑ k s ɪ z əʊ (el)
a'rxi	(en) a ə k s i (el)
ana'valo	(en) a n ɐ v ə l əʊ (el)
ar'ɣo	(en) eɪ ɑ  k w əʊ t  ɡ a m ə  əʊ (el)
'viazome	(en) v aɪ ə z əʊ m (el)
ar'ɣos	(en) eɪ ɑ  k w əʊ t  ɡ a m ə  əʊ ɛ s (el)
'ɣriɣoros	(en) ɡ a m ə   ɡ a m ə  ɑ ɹ aɪ  ɡ a m ə  əʊ ɑ ɹ əʊ ɛ s (el)
a'mesos	(en) a m i s əʊ z (el)
'tora	(en) t ɔ ɹ ə (el)
ar'ɣa	(en) eɪ ɑ  k w əʊ t  ɡ a m ə  eɪ (el)
no'ris	(en) n ɒ ɹ ɪ s (el)
'ɣeros	 (en) ɡ a m ə  i  ɑ ɹ əʊ ɛ s (el)
ilikio'menos	(en) ɪ l ɪ k ɪ  ə m i n əʊ z (el)
'neos	(en) n i  əʊ z (el)
nea'ros	(en) n i ɹ əʊ z (el)
ili'kia	(en) ɪ l ɪ k iə (el)
'neos	(en) n i  əʊ z (el)
ke'nurios	(en) k ɛ n j ʊ ɹ ɪ  əʊ z (el)
'ora	(en) ɔ ɹ ə (el)
'xronos	(en) ɛ k s ɹ əʊ n əʊ z (el)
ke'ros	(en) k ɛ ɹ əʊ z (el)
'tritos	(en) t ɹ aɪ t əʊ z (el)
ze'vɣari	(en) z ɛ d i  k w əʊ t v i  ɡ a m ə  eɪ ɑ ɹ aɪ (el)
'ðefteros	(en) ð ɛ f t eə ɹ əʊ z (el)
tele'fteos	(en) t ɛ l ɪ f t ɪ  əʊ z (el)
'protos	(en) p ɹ əʊ t əʊ z (el)
'monos	(en) m ɒ n əʊ z (el)
'mono	(en) m ɒ n əʊ (el)
mi'sos	(en) m ɪ s əʊ z (el)
ko'mati	(en) k ə m ɑ t i (el)
'meros	(en) m iə ɹ əʊ z (el)
'aðios	(en) a ð ɪ  əʊ z (el)
ɣe'matos	 (en) ɡ a m ə  i  k w əʊ t ɛ m eɪ t i  əʊ ɛ s (el)
'pliθos	(en) p l aɪ (el) θ i t a (en) əʊ ɛ s (el)
li'ɣaki	(en) ɛ l aɪ  k w əʊ t  ɡ a m ə  eɪ k eɪ aɪ (el)
'liɣo	(en) ɛ l aɪ  ɡ a m ə  əʊ (el)
arke'ta	(en) ɑ k ɛ t ə (el)
a'komi	(en) a k əʊ m i (el)
peri'sotero	(en) p ɛ ɹ ɪ s ə t eə ɹ əʊ (el)
po'li	(en) p ɒ l i (el)
'kaθe	(en) k ɑ (el) θ i t a (en) i (el)
'oli	(en) əʊ l i (el)
me'trao	(en) m ɛ t ɹ aʊ (el)
loɣa'riazo	(en) ɛ l əʊ  ɡ a m ə  eɪ  k w əʊ t ɑ ɹ aɪ eɪ z ɛ d əʊ (el)
'xilia	(en) z ɪ l i  ə (el)
eka'to	(en) ɛ k a t əʊ (el)
'ikosi	(en) aɪ k əʊ s i (el)
ðeka'pede	(en) ð ɛ k ɐ p i d (el)
'ðoðeka	(en) ð əʊ ð k ə (el)
'edeka	(en) ɛ d ɛ k ə (el)
'ðeka	(en) ð ɛ k ə (el)
e'nea	(en) ɛ n iə (el)
o'xto	(en) əʊ k s t əʊ (el)
e'fta	(en) ɛ f t ə (el)
'eksi	(en) ɛ k s i (el)
'pede	(en) p i d (el)
'tesera	(en) t ɛ s ə ɹ ə (el)
'ðio	(en) ð i  əʊ (el)
'tria	(en) t ɹ aɪ ə (el)
'ena	(en) i n ə (el)
mi'ðen	(en) m ɪ ð ə n (el)
'tipota	(en) t ɪ p əʊ t ə (el)
a'lazo	(en) a l eɪ z əʊ (el)
pa'romios	(en) p a ɹ əʊ m ɪ  əʊ z (el)
ɣra'mi	(en) ɡ a m ə  ɹ a m i (el)
si'ra	(en) s ɪ ɹ ə (el)
'tripa	(en) t ɹ aɪ p ə (el)
'sfera	(en) ɛ s f iə ɹ ə (el)
'bala	(en) b ɑ l ə (el)
strogi'los	(en) s t ɹ ə dʒ ɪ l əʊ z (el)
'kiklos	(en) k ɪ k l əʊ z (el)
te'traɣonos	(en) t i  i  k w əʊ t t i  ɑ ɹ eɪ  ɡ a m ə  əʊ ɛ n əʊ ɛ s (el)
sta'vros	(en) s t a v ɹ əʊ z (el)
ɣo'nia	 (en) ɡ a m ə  əʊ  k w əʊ t ɛ n aɪ eɪ (el)
'ɣatzos	 (en) ɡ a m ə  eɪ t i z ɛ d əʊ ɛ s (el)
stra'vos	(en) s t ɹ a v əʊ z (el)
'isios	(en) ɪ s ɪ  əʊ z (el)
e'fθis	(en) ɛ f (el) θ i t a (en) ɪ z (el)
e'pipeðos	(en) ɛ p aɪ p ð əʊ z (el)
a'navaθos	(en) a n ɑ v ə (el) θ i t a (en) əʊ ɛ s (el)
ri'xos	(en) ɹ ɪ k s əʊ z (el)
va'θis	(en) v a θ i t ə  ɪ z (el)
le'ptos	(en) l ɛ p t əʊ z (el)
a'ðinatos	(en) a ð ɪ n ɑ t əʊ z (el)
pa'xis	(en) p a k s ɪ s (el)
ste'nos	(en) s t ɛ n əʊ z (el)
far'ðis	(en) f ɑ ð i z (el)
pla'tis	(en) p l a t i z (el)
ko'dos	(en) k ɒ d əʊ z (el)
psi'los	(en) s ɪ l əʊ z (el)
ma'kris	(en) m a k ɹ ɪ s (el)
mi'kros	(en) m ɪ k ɹ əʊ z (el)
ko'dos	(en) k ɒ d əʊ z (el)
me'ɣalos	(en) ɛ m i  k w əʊ t  ɡ a m ə  eɪ ɛ l əʊ ɛ s (el)
psi'los	(en) s ɪ l əʊ z (el)
xo'dros	(en) z ɒ d ɹ əʊ z (el)
or'ɣia	(en) əʊ ɑ  k w əʊ t  ɡ a m ə  aɪ eɪ (el)
me'trao	(en) m ɛ t ɹ aʊ (el)
meɣa'lono	(en) ɛ m i  ɡ a m ə  eɪ  k w əʊ t ɛ l əʊ ɛ n əʊ (el)
ana'ptisome	(en) a n ɐ p t i s ʌ m (el)
'notos	(en) n əʊ t əʊ z (el)
vo'ras	(en) v ɒ ɹ ə z (el)
'ðisi	(en) ð ɪ s i (el)
anato'li	(en) a n ɐ t ɒ l i (el)
ko'da	(en) k ɒ d ə (el)
makri'a	(en) m a k ɹ ɪ  ə (el)
ariste'ri	(en) a ɹ ɪ s t ɛ ɹ i (el)
ðeksi'a	(en) ð ɛ k s ɪ  ə (el)
'mesi	(en) m ɛ s i (el)
'kedro	(en) k ɛ d ɹ əʊ (el)
ple'vra	(en) p l ɛ v ɹ ə (el)
'akri	(en) a k ɹ i (el)
'kopsi	(en) k ɒ p s i (el)
mite'ros	(en) m aɪ t ɹ əʊ z (el)
'akri	(en) a k ɹ i (el)
'akro	(en) a k ɹ əʊ (el)
'terma	(en) t ɜ m ə (el)
'vaθos	(en) v ɑ (el) θ i t a (en) əʊ ɛ s (el)
xami'los	(en) z a m ɪ l əʊ z (el)
kori'fi	(en) k ɔ ɹ ɪ f i (el)
psi'los	(en) s ɪ l əʊ z (el)
'krivo	(en) k ɹ i v əʊ (el)
'klino	(en) k l i n əʊ (el)
ka'lipto	(en) k a l ɪ p t əʊ (el)
ske'pazo	(en) s k ɛ p ɑ z əʊ (el)
a'niɣo	(en) eɪ  k w əʊ t ɛ n aɪ  ɡ a m ə  əʊ (el)
ðie'ro	(en) ð i ɹ əʊ (el)
xo'rizo	(en) z ə ɹ ɪ z əʊ (el)
e'nono	(en) ɛ n əʊ n əʊ (el)
sin'ðeo	(en) s ɪ n ð ɪ  əʊ (el)
sti'vazo	(en) s t ɪ v ɑ z əʊ (el)
ma'zevo	(en) m a z i v əʊ (el)
ma'zevo	(en) m a z i v əʊ (el)
sige'drono	(en) s aɪ dʒ d ɹ əʊ n əʊ (el)
i'polipo	(en) aɪ p ə l ɪ p əʊ (el)
pe'risevma	(en) p ɛ ɹ aɪ s v m ə (el)
i'polima	(en) aɪ p ɒ l ɪ m ə (el)
'meno	(en) m i n əʊ (el)
peri'meno	(en) p ɛ ɹ ɪ m i n əʊ (el)
ksa'plono	(en) k eɪ s a p l əʊ n əʊ (el)
'kaθome	(en) k ɑ (el) θ i t a (en) əʊ m (el)
'vazo	(en) v ɑ z əʊ (el)
'meros	(en) m iə ɹ əʊ z (el)
'θesi	θ i t a (en) ɛ s i (el)
'topos	(en) t əʊ p əʊ z (el)
'pano	(en) p ɑ n əʊ (el)
apo'pano	(en) ɐ p ə p ɑ n əʊ (el)
apo'kato	(en) ɐ p ə k ɑ t əʊ (el)
'ekso	(en) ɛ k s əʊ (el)
'mesa	(en) m eɪ s ə (el)
'se	(en) s i (el)
bro'sta	(en) b ɹ ɒ s t ə (el)
'prin	(en) p ɹ ɪ n (el)
'kato	(en) k ɑ t əʊ (el)
'ðipla	(en) ð ɪ p l ə (el)
'plai	(en) p l aɪ (el)
'piso	(en) p aɪ z əʊ (el)
me'ta	(en) m ɛ t ə (el)
zi'ɣizo	(en) z ɛ d aɪ  k w əʊ t  ɡ a m ə  aɪ z ɛ d əʊ (el)
mi'razo	(en) m ɪ ɹ ɑ z əʊ (el)
mi'razome	(en) m ɪ ɹ ɐ z əʊ m (el)
fti'nos	(en) ɛ f t ɪ n əʊ z (el)
akri'vos	(en) a k ɹ ɪ v əʊ z (el)
ti'mi	(en) t ɪ m i (el)
maɣa'zi	(en) ɛ m eɪ  ɡ a m ə  eɪ  k w əʊ t z ɛ d aɪ (el)
ka'tastima	(en) k a t eɪ s t ɪ m ə (el)
aɣo'ra	(en) eɪ  ɡ a m ə  əʊ  k w əʊ t ɑ ɹ eɪ (el)
'eboros	(en) ɛ b ə ɹ əʊ z (el)
sinala'ɣi	(en) ɛ s aɪ ɛ n eɪ ɛ l eɪ  k w əʊ t  ɡ a m ə  aɪ (el)
adala'ɣi	(en) eɪ d i  eɪ ɛ l eɪ  k w əʊ t  ɡ a m ə  aɪ (el)
pu'lao	(en) p ʌ l aʊ (el)
aɣo'razo	(en) eɪ  ɡ a m ə  əʊ  k w əʊ t ɑ ɹ eɪ z ɛ d əʊ (el)
ker'ðizo	(en) k ɜ ð ɪ z əʊ (el)
mi'sθos	(en) m aɪ z (el) θ i t a (en) əʊ ɛ s (el)
ni'kiazo	(en) n ɪ k ɪ  ɑ z əʊ (el)
'foros	(en) f ɔ ɹ əʊ z (el)
loɣaria'smos	(en) ɛ l əʊ  ɡ a m ə  eɪ ɑ ɹ aɪ eɪ  k w əʊ t ɛ s ɛ m əʊ ɛ s (el)
pli'rono	(en) p l ɪ ɹ əʊ n əʊ (el)
'xreos	(en) ɛ k s ɹ ɪ  əʊ z (el)
xro'stao	(en) ɛ k s ɹ ɒ s t aʊ (el)
ða'nizome	(en) ð a n ɪ z əʊ m (el)
ða'nizo	(en) ð a n ɪ z əʊ (el)
fi'larɣiros	(en) ɛ f aɪ  k w əʊ t ɛ l eɪ ɑ  ɡ a m ə  aɪ  ɑ ɹ əʊ ɛ s (el)
tsi'gunis	(en) t s ɪ ɡ u n i z (el)
zi'tianos	(en) z ɪ ʃ iə n əʊ z (el)
fto'xos	(en) ɛ f t ɒ k s əʊ z (el)
'plusios	(en) p l u s ɪ  əʊ z (el)
'nomisma	(en) n ɒ m ɪ s m ə (el)
'xrima	(en) ɛ k s ɹ i m ə (el)
lef'ta	(en) l ɛ f t ə (el)
(ap)elefθe'rono	  (en) a p (el)   (en) ɪ l ɛ f (el) θ i t a (en) ɛ ɹ əʊ n əʊ (el)
'xano	(en) z ɑ n əʊ (el)
'vrisko	(en) v i ɹ ɪ s k əʊ (el)
'psaxno	(en) s a k s n əʊ (el)
pli'ɣono	(en) p i  ɛ l aɪ  k w əʊ t  ɡ a m ə  əʊ ɛ n əʊ (el)
travma'tizo	(en) t ɹ a v m ɐ t ɪ z əʊ (el)
'vlapto	(en) v l a p t əʊ (el)
kata'strefo	(en) k a t ɐ s t ɹ i f əʊ (el)
'sozo	(en) s əʊ z əʊ (el)
ðia'sozo	(en) ð aɪ ə s əʊ z əʊ (el)
ɣli'tono	(en) ɡ a m ə  l ɪ t əʊ n əʊ (el)
prosta'tevo	(en) p ɹ ɒ s t ɐ t i v əʊ (el)
profi'laso	(en) p ɹ ɒ f ɪ l ɑ s əʊ (el)
epi'strefo	(en) ɛ p ɪ s t ɹ i f əʊ (el)
'ðino	(en) ð i n əʊ (el)
'praɣma	(en) p i  ɑ ɹ eɪ  ɡ a m ə  ɛ m eɪ (el)
fi'lao	(en) f ɪ l aʊ (el)
kra'tao	(en) k ɹ a t aʊ (el)
apo'kto	(en) ɐ p ɒ k t əʊ (el)
kra'tao	(en) k ɹ a t aʊ (el)
pi'ano	(en) p ɪ  ɑ n əʊ (el)
ar'pazo	(en) ɑ p ɑ z əʊ (el)
'perno	(en) p ɜ n əʊ (el)
'exo	(en) ɛ ɡ z əʊ (el)
ka'texo	(en) k a t i k s əʊ (el)
'exo	(en) ɛ ɡ z əʊ (el)
apovi'vazo	(en) ɐ p ɒ v ɪ v ɑ z əʊ (el)
apovi'vazome	(en) ɐ p ɒ v ɪ v a z əʊ m (el)
li'mani	(en) l ɪ m ɑ n ɪ (el)
'agira	(en) a dʒ iə ɹ ə (el)
pa'ni	(en) p a n i (el)
ka'tarti	(en) k a t ɑ t i (el)
ti'moni	(en) t ɪ m əʊ n i (el)
pi'ðalio	(en) p ɪ ð a l ɪ  əʊ (el)
kopila'to	(en) k ɒ p ɪ l a t əʊ (el)
ku'pi	(en) k ʌ p i (el)
ku'pi	(en) k ʌ p i (el)
sxe'ðia	(en) ɛ s z ɛ ð i  ə (el)
ekre'mes	(en) ɛ k ɹ ɛ m z (el)
ka'no	(en) k a n əʊ (el)
pi'roɣa	(en) p i  aɪ  k w əʊ t ɑ ɹ əʊ  ɡ a m ə  eɪ (el)
'plio	(en) p l i  əʊ (el)
ka'ravi	(en) k a ɹ ɐ v i (el)
'skafos	(en) s k ɑ f əʊ z (el)
'plio	(en) p l i  əʊ (el)
ka'ravi	(en) k a ɹ ɐ v i (el)
zi'ɣos	(en) z ɛ d aɪ  k w əʊ t  ɡ a m ə  əʊ ɛ s (el)
'aksonas	(en) a k s əʊ n ə z (el)
'roða	(en) ɹ əʊ ð ə (el)
tro'xos	(en) t ɹ ɒ k s əʊ z (el)
va'ɣoni	(en) v i  eɪ  k w əʊ t  ɡ a m ə  əʊ ɛ n aɪ (el)
karo	(en) k a ɹ əʊ (el)
'ɣefira	 (en) ɡ a m ə  i  ɛ f aɪ  ɑ ɹ eɪ (el)
mono'pati	(en) m ɒ n əʊ p ɑ t i (el)
'ðromos	(en) d ɹ əʊ m əʊ z (el)
'ðromos	(en) d ɹ əʊ m əʊ z (el)
o'ðos	(en) əʊ ð ɒ s (el)
'sproxno	(en) s p ɹ ɒ k s n əʊ (el)
epi'veno	(en) ɛ p ɪ v i n əʊ (el)
kavali'kevo	(en) k a v ɐ l ɪ k i v əʊ (el)
oði'ɣo	(en) əʊ ɛ ð aɪ  k w əʊ t  ɡ a m ə  əʊ (el)
oði'ɣo	(en) əʊ ɛ ð aɪ  k w əʊ t  ɡ a m ə  əʊ (el)
'stelno	(en) s t ɛ l n əʊ (el)
'pao	(en) p aʊ (el)
'ferno	(en) f ɜ n əʊ (el)
meta'fero	(en) m ɛ t ə f eə ɹ əʊ (el)
'beno	(en) b ɪ n əʊ (el)
plisi'azo	(en) p l ɪ s ɪ  ɑ z əʊ (el)
'ftano	(en) ɛ f t ɑ n əʊ (el)
parakolu'θo	(en) p a ɹ ə k ɒ l ə θ i t ə  əʊ (el)
akolu'θo	(en) a k ə l ə θ i t ə  əʊ (el)
apo'ðro	(en) ɐ p ɒ ð ɹ əʊ (el)
eksafa'nizome	(en) ɛ k s ɐ f a n ɪ z əʊ m (el)
'fevɣo	(en) ɛ f i v i  ɡ a m ə  əʊ (el)
anaxo'ro	(en) a n ɐ k s ɒ ɹ əʊ (el)
epi'strefo	(en) ɛ p ɪ s t ɹ i f əʊ (el)
'erxome	(en) ɜ k s əʊ m (el)
'vɣeno	(en) v i v i  ɡ a m ə  i  ɛ n əʊ (el)
kate'veno	(en) k eɪ t v i n əʊ (el)
skarfa'lono	(en) s k ɑ f ɐ l əʊ n əʊ (el)
pi'ɣeno	(en) p i  aɪ  k w əʊ t  ɡ a m ə  i  ɛ n əʊ (el)
'pao	(en) p aʊ (el)
ane'veno	(en) eɪ n v i n əʊ (el)
'trexo	(en) t ɹ i k s əʊ (el)
ku'tseno	(en) k ʌ t s i n əʊ (el)
perpa'tao	(en) p ɜ p ɐ t aʊ (el)
xo'revo	(en) z ə ɹ i v əʊ (el)
klo'tsao	(en) k l ɒ t s aʊ (el)
pi'ðao	(en) p ɪ ð aʊ (el)
ɣli'strao	(en) ɡ a m ə  l ɪ s t ɹ aʊ (el)
ɣona'tizo	 (en) ɡ a m ə  əʊ ɛ n eɪ  k w əʊ t t i  aɪ z ɛ d əʊ (el)
'sernome	(en) s ɜ n əʊ m (el)
fi'sao	(en) f ɪ s aʊ (el)
pe'tao	(en) p ɛ t aʊ (el)
'pleo	(en) p l i  əʊ (el)
pitsi'lizo	(en) p ɪ t s ɪ l ɪ z əʊ (el)
vu'tao	(en) v ʌ t aʊ (el)
koli'bao	(en) k ə l ɪ b aʊ (el)
epi'pleo	(en) ɛ p ɪ p l eɪ əʊ (el)
vi'θizome	(en) v ɪ θ i t ə  aɪ z əʊ m (el)
vu'liazo	(en) v ʌ l ɪ  ɑ z əʊ (el)
ki'lao	(en) k ɪ l aʊ (el)
'reo	(en) ɹ i  əʊ (el)
ti'nazo	(en) t ɪ n ɑ z əʊ (el)
tra'dazo	(en) t ɹ a d ɑ z əʊ (el)
anaki'no	(en) a n ɐ k ɪ n əʊ (el)
'piano	(en) p ɪ  a n əʊ (el)
silam'vano	(en) s ɪ l ɐ m v ɑ n əʊ (el)
pe'tao	(en) p ɛ t aʊ (el)
'rixno	(en) ɹ ɪ k s n əʊ (el)
'stazo	(en) s t ɑ z əʊ (el)
'pefto	(en) p ɛ f t əʊ (el)
si'kono	(en) s ɪ k əʊ n əʊ (el)
i'psono	(en) aɪ p s əʊ n əʊ (el)
ana'trefo	(en) a n ɐ t ɹ i f əʊ (el)
ane'veno	(en) eɪ n v i n əʊ (el)
si'konome	(en) s ɪ k ə n əʊ m (el)
'strivo	(en) s t ɹ i v əʊ (el)
a'fino	(en) a f i n əʊ (el)
ki'lao	(en) k ɪ l aʊ (el)
'trexo	(en) t ɹ i k s əʊ (el)
ti'liɣo	(en) t i  aɪ  k w əʊ t ɛ l aɪ  ɡ a m ə  əʊ (el)
ɣi'rizo	 (en) ɡ a m ə  aɪ  k w əʊ t ɑ ɹ aɪ z ɛ d əʊ (el)
'strefome	(en) s t ɹ ɛ f əʊ m (el)
anapoðoɣi'rizo	(en) eɪ ɛ n eɪ p i  əʊ ɛ ð əʊ  ɡ a m ə  aɪ  k w əʊ t ɑ ɹ aɪ z ɛ d əʊ (el)
ɣi'rizo	 (en) ɡ a m ə  aɪ  k w əʊ t ɑ ɹ aɪ z ɛ d əʊ (el)
ku'nao	(en) k ʌ n aʊ (el)
ki'nume	(en) k ɪ n j u m (el)
zoɣra'fizo	(en) z ɛ d əʊ  ɡ a m ə  ɑ ɹ eɪ  k w əʊ t ɛ f aɪ z ɛ d əʊ (el)
zoɣrafi'ki	(en) z ɛ d əʊ  ɡ a m ə  ɑ ɹ eɪ ɛ f aɪ  k w əʊ t k eɪ aɪ (el)
'aɣalma	(en) eɪ  ɡ a m ə  eɪ ɛ l ɛ m eɪ (el)
'ɣliptis	(en) ɡ a m ə  l ɪ p t i z (el)
la'ksevo	(en) l a k s i v əʊ (el)
xa'razo	(en) z a ɹ ɑ z əʊ (el)
ae'rizome	(en) i ɹ ɪ z əʊ m (el)
ve'dalia	(en) v ɛ d eɪ l iə (el)
'ðixti	(en) ð ɪ k s t i (el)
xa'li	(en) z a l i (el)
'psaθa	(en) p i  ɛ s eɪ (el) θ i t a (en) eɪ (el)
xa'laki	(en) z a l a k i (el)
ka'laθi	(en) k a l ə (el) θ i t a (en) aɪ (el)
i'feno	(en) aɪ f i n əʊ (el)
'dino	(en) d i n əʊ (el)
'pleko	(en) p l i k əʊ (el)
ɣia'li	 (en) ɡ a m ə  aɪ eɪ  k w əʊ t ɛ l aɪ (el)
'arɣilos	(en) eɪ ɑ  ɡ a m ə  aɪ ɛ l əʊ ɛ s (el)
arɣi'loxoma	(en) eɪ ɑ  ɡ a m ə  aɪ  k w əʊ t ɛ l əʊ ɛ k s əʊ ɛ m eɪ (el)
kalu'pono	(en) k a l ə p əʊ n əʊ (el)
for'maro	(en) f ɔ m a ɹ əʊ (el)
keramopi'os	(en) k ɛ ɹ ɐ m ɒ p ɪ  əʊ z (el)
ka'siteros	(en) k a s ɪ t eə ɹ əʊ z (el)
'molivðos	(en) m ə l ɪ v ð əʊ z (el)
'siðiros	(en) s ɪ ð iə ɹ əʊ z (el)
xal'kos	(en) z a l k əʊ z (el)
a'simi	(en) a s ɪ m i (el)
'arɣiros	(en) eɪ ɑ  ɡ a m ə  aɪ  ɑ ɹ əʊ ɛ s (el)
xri'sos	(en) ɛ k s ɹ ɪ s əʊ z (el)
a'moni	(en) a m əʊ n i (el)
sfirila'to	(en) ɛ s f ɪ ɹ ɪ l a t əʊ (el)
siðe'ras	(en) s aɪ ð ɹ ə z (el)
'kola	(en) k əʊ l ə (el)
kar'fi	(en) k ɑ f i (el)
sfi'ri	(en) ɛ s f ɪ ɹ i (el)
pri'oni	(en) p ɹ ɪ  əʊ n i (el)
'skavo	(en) s k ɑ v əʊ (el)
tri'pao	(en) t ɹ ɪ p aʊ (el)
'xtizo	(en) ɛ k s t i z əʊ (el)
ksilur'ɣos	(en) k eɪ k eɪ ɛ s aɪ ɛ l j u ɑ  k w əʊ t  ɡ a m ə  əʊ ɛ s (el)
erɣa'lio	(en) i  ɑ  ɡ a m ə  eɪ  k w əʊ t ɛ l aɪ əʊ (el)
'skupa	(en) s k j u p ə (el)
'pleno	(en) p l i n əʊ (el)
sku'pizo	(en) s k ʌ p ɪ z əʊ (el)
'xino	(en) z i n əʊ (el)
'rixno	(en) ɹ ɪ k s n əʊ (el)
pi'ezo	(en) p ɪ  i z əʊ (el)
'stivo	(en) s t i v əʊ (el)
pi'ezo	(en) p ɪ  i z əʊ (el)
pa'tao	(en) p a t aʊ (el)
kre'mao	(en) k ɹ ɛ m aʊ (el)
a'plono	(en) a p l əʊ n əʊ (el)
skor'pizo	(en) s k ɔ p ɪ z əʊ (el)
tra'vao	(en) t ɹ a v aʊ (el)
a'plono	(en) a p l əʊ n əʊ (el)
'trivo	(en) t ɹ aɪ v əʊ (el)
sku'pizo	(en) s k ʌ p ɪ z əʊ (el)
'ɣðerno	(en) ɡ a m ə  ð ɜ n əʊ (el)
'skizo	(en) s k i z əʊ (el)
'skizo	(en) s k i z əʊ (el)
'spao	(en) s p aʊ (el)
tse'kuri	(en) t s ɛ k j ʊ ɹ i (el)
ske'parni	(en) s k ɛ p ɑ n i (el)
psa'liði	(en) s a l ɪ ð i (el)
ma'xeri	(en) m a k s ə ɹ i (el)
maxe'rono	(en) m a k s ɪ ɹ əʊ n əʊ (el)
kla'ðevo	(en) k l a ð i v əʊ (el)
'kovo	(en) k əʊ v əʊ (el)
kateða'fizo	(en) k eɪ t ð ɐ f ɪ z əʊ (el)
'kovo	(en) k əʊ v əʊ (el)
ɣronθoko'po	(en) ɡ a m ə  ɹ ɒ n (el) θ i t a (en) ɒ k ɒ p əʊ (el)
xti'pao	(en) ɛ k s t ɪ p aʊ (el)
'kobos	(en) k əʊ b əʊ z (el)
ski'ni	(en) s k ɪ n i (el)
ali'siða	(en) a l ɪ s ɪ ð ə (el)
'lino	(en) l i n əʊ (el)
'ðeno	(en) ð i n əʊ (el)
ði'plono	(en) ð ɪ p l əʊ n əʊ (el)
ði'plono	(en) ð ɪ p l əʊ n əʊ (el)
ðu'levo	(en) ð ʌ l i v əʊ (el)
er'ɣazome	(en) i  ɑ  k w əʊ t  ɡ a m ə  eɪ z ɛ d əʊ ɛ m i (el)
'kano	(en) k ɑ n əʊ (el)
'ftiaxno	(en) ɛ f t aɪ ə k s n əʊ (el)
mani'tari	(en) m a n ɪ t ɑ ɹ i (el)
tsu'kniða	(en) t s u k n ɪ ð ə (el)
zaxaro'kalamo	(en) z a k s ɐ ɹ ə k a l ə m əʊ (el)
ba'bu	(en) b a b u (el)
ɣlikokolo'kiθa	(en) ɡ a m ə  l ɪ k ə k ɒ l ə k i (el) θ i t a (en) eɪ (el)
kolo'kiθa	(en) k ɒ l ə k i (el) θ i t a (en) eɪ (el)
nerokolo'kiθa	(en) n ɛ ɹ ə k ɒ l ə k i (el) θ i t a (en) eɪ (el)
[tapi'oka	  (en) t a p ɪ  əʊ k ə (el)
mani'oka]	(en) m a n ɪ  əʊ k ə (el)
ɣlikopa'tata	(en) ɡ a m ə  l ɪ k ə p ɐ t ɑ t ə (el)
'iɣnamo	(en) aɪ  ɡ a m ə  ɛ n eɪ ɛ m əʊ (el)
ɣlikopa'tata	(en) ɡ a m ə  l ɪ k ə p ɐ t ɑ t ə (el)
'kitro	(en) k ɪ t ɹ əʊ (el)
ka'riða	(en) k a ɹ ɪ ð ə (el)
'finikas	(en) f ɪ n ɪ k ə z (el)
fli'os	(en) f l ɪ  əʊ z (el)
kor'mos	(en) k ɔ m əʊ z (el)
'kutsuro	(en) k ʌ t s ɜ ɹ əʊ (el)
'pipa	(en) p i p ə (el)
ka'pnizo	(en) k a p n ɪ z əʊ (el)
ka'pnos	(en) k a p n əʊ z (el)
a'beli	(en) a b ɪ l i (el)
vela'niði	(en) v ɛ l ɐ n ɪ ð i (el)
'elato	(en) ɪ l ɑ t əʊ (el)
'pefko	(en) p ɛ f k əʊ (el)
si'miða	(en) s ɪ m ɪ ð ə (el)
o'ksia	(en) əʊ k s iə (el)
velani'ðia	(en) v ɛ l ɐ n ɪ ð iə (el)
'ðedro	(en) ð ɛ d ɹ əʊ (el)
lu'luði	(en) l ʌ l u ð i (el)
'anθos	(en) ɐ n (el) θ i t a (en) əʊ ɛ s (el)
'filo	(en) f aɪ l əʊ (el)
kla'ði	(en) k l a ð i (el)
klo'nari	(en) k l ə n ɑ ɹ i (el)
'riza	(en) ɹ i z ə (el)
fi'tevo	(en) f ɪ t i v əʊ (el)
sa'nos	(en) s a n əʊ z (el)
'axiro	(en) a k s iə ɹ əʊ (el)
fi'to	(en) f ɪ t əʊ (el)
'xorto	(en) z ɔ t əʊ (el)
xor'tari	(en) z ɔ t ɑ ɹ i (el)
'rizi	(en) ɹ ɪ z i (el)
kala'boki	(en) k a l ɐ b əʊ k i (el)
'vromi	(en) v i ɹ əʊ m i (el)
'sikali	(en) s ɪ k ɑ l i (el)
'stari	(en) s t ɑ ɹ i (el)
si'tari	(en) s ɪ t ɑ ɹ i (el)
kri'θari	(en) k ɹ ɪ θ i t ə  ɑ ɹ i (el)
spi'ri	(en) s p ɪ ɹ i (el)
'sporos	(en) s p ɔ ɹ əʊ z (el)
θeri'smos	θ i t a (en) ɪ ɹ ɪ s m əʊ z (el)
a'loni	(en) a l əʊ n i (el)
alo'nizo	(en) ɐ l ə n ɪ z əʊ (el)
ðre'pani	(en) d ɹ ɛ p ɑ n ɪ (el)
ku'revo	(en) k ʌ ɹ i v əʊ (el)
ma'zevo	(en) m a z i v əʊ (el)
'sporos	(en) s p ɔ ɹ əʊ z (el)
'sperno	(en) s p ɜ n əʊ (el)
tsu'grana	(en) t s u ɡ ɹ ɑ n ə (el)
pi'runi	(en) p ɪ ɹ u n i (el)
'tsapa	(en) t s ɑ p ə (el)
'ftiari	(en) ɛ f t aɪə ɹ i (el)
a'ksina	(en) a k s ɪ n ə (el)
a'vlaki	(en) a v l a k i (el)
'skavo	(en) s k ɑ v əʊ (el)
or'ɣono	(en) əʊ ɑ  k w əʊ t  ɡ a m ə  əʊ ɛ n əʊ (el)
a'letri	(en) a l ɪ t ɹ i (el)
xa'daki	(en) z a d a k i (el)
'tafros	(en) t a f ɹ əʊ z (el)
'fraxtis	(en) f ɹ a k s t i z (el)
kalier'ɣo	(en) k eɪ eɪ ɛ l aɪ i  ɑ  k w əʊ t  ɡ a m ə  əʊ (el)
or'ɣono	(en) əʊ ɑ  k w əʊ t  ɡ a m ə  əʊ ɛ n əʊ (el)
'kipos	(en) k i p əʊ z (el)
peri'voli	(en) p ɛ ɹ ɪ v ɒ l i (el)
xo'rafi	(en) z ɒ ɹ ɐ f i (el)
a'ɣrotis	(en) eɪ  k w əʊ t  ɡ a m ə  ɑ ɹ əʊ t i  aɪ ɛ s (el)
ɣeor'ɣos	 (en) ɡ a m ə  i  əʊ ɑ  k w əʊ t  ɡ a m ə  əʊ ɛ s (el)
'pliθa	(en) p l aɪ (el) θ i t a (en) eɪ (el)
asve'stolaspi	(en) ɐ s v ɛ s t ə l a s p i (el)
'tuvlo	(en) t ʌ v l əʊ (el)
a'psiða	(en) a p s ɪ ð ə (el)
ka'mara	(en) k a m ɑ ɹ ə (el)
'xtistis	(en) ɛ k s t ɪ s t i z (el)
iko'ðomos	(en) aɪ k ə ð əʊ m əʊ z (el)
sa'niða	(en) s a n ɪ ð ə (el)
'stilos	(en) s t i l əʊ z (el)
'pasalos	(en) p eɪ z ə l əʊ z (el)
ðo'kari	(en) ð ə k ɑ ɹ i (el)
ðo'kos	(en) ð ɒ k əʊ z (el)
ma'ðeri	(en) m a ð ə ɹ i (el)
ðo'kari	(en) ð ə k ɑ ɹ i (el)
ðo'kos	(en) ð ɒ k əʊ z (el)
ka'ðroni	(en) k a ð ɹ əʊ n i (el)
axiroske'pi	(en) a k s ɪ ɹ ɒ s k ɪ p i (el)
kalamoske'pi	(en) k a l ɐ m ɒ s k ɪ p i (el)
'steɣi	(en) ɛ s t i  i  ɡ a m ə  aɪ (el)
ske'pi	(en) s k ɛ p i (el)
'skafi	(en) s k a f i (el)
po'tistra	(en) p ɒ t ɪ s t ɹ ə (el)
eta'zera	(en) ɛ t ɐ z ə ɹ ə (el)
'rafi	(en) ɹ a f i (el)
ke'ri	(en) k ɛ ɹ i (el)
'laba	(en) l ɑ b ə (el)
'ɣlobos	(en) ɡ a m ə  l əʊ b əʊ z (el)
tra'pezi	(en) t ɹ a p ɪ z i (el)
ka'rekla	(en) k a ɹ ɛ k l ə (el)
ku'verta	(en) k ʌ v ɜ t ə (el)
maksi'lari	(en) m a k s ɪ l ɑ ɹ i (el)
kre'vati	(en) k ɹ ɛ v ɑ t i (el)
'skala	(en) s k ɑ l ə (el)
'tzaki	(en) t i z a k i (el)
'soba	(en) s əʊ b ə (el)
e'stia	(en) ɛ s tʃ ə (el)
'tixos	(en) t ɪ k s əʊ z (el)
'patoma	(en) p a t əʊ m ə (el)
pa'raθiro	(en) p a ɹ ə (el) θ i t a (en) ɪ ɹ əʊ (el)
kli'ði	(en) k l ɪ ð i (el)
'sirtis	(en) s ɪ  ə t i z (el)
kliða'ria	(en) k l ɪ ð a ɹ iə (el)
kliða'ria	(en) k l ɪ ð a ɹ iə (el)
lu'keto	(en) l ʌ k i t əʊ (el)
ko'lona	(en) k ə l əʊ n ə (el)
'stilos	(en) s t i l əʊ z (el)
ðo'matio	(en) ð ə m eɪ ʃ ɪ  əʊ (el)
'porta	(en) p ɔ t ə (el)
ku'zina	(en) k ʌ z ɪ n ə (el)
a'vli	(en) a v l i (el)
ski'ni	(en) s k ɪ n i (el)
ka'liva	(en) k a l aɪ v ə (el)
'spiti	(en) s p i t i (el)
i'kia	(en) aɪ k ɪ  ə (el)
'meno	(en) m i n əʊ (el)
kati'ko	(en) k a t ɪ k əʊ (el)
ka'θreftis	(en) k a θ i t ə  ɹ ɪ f t i z (el)
sa'puni	(en) s a p u n i (el)
ali'fi	(en) a l ɪ f i (el)
ksi'rafi	(en) k eɪ s ɪ ɹ ɐ f i (el)
ksira'faki	(en) k eɪ s ɜ ɹ ɐ f a k i (el)
'vurtsa	(en) v ɜ t s ə (el)
tsa'tsara	(en) t s a t s ɑ ɹ ə (el)
'xtena	(en) ɛ k s t i n ə (el)
pe'tseta	(en) p ɛ t s ɛ t ə (el)
ma'dili	(en) m a d ɪ l i (el)
madi'laki	(en) m a d ɪ l a k i (el)
patsa'vura	(en) p a t s ɐ v j ʊə ɹ ə (el)
tatu'az	(en) t a t ə ɹ a z (el)
ma'dili	(en) m a d ɪ l i (el)
ma'dila	(en) m a d ɪ l ə (el)
ba'dana	(en) b a d ɑ n ə (el)
skula'riki	(en) s k j ʊ l ɐ ɹ ɪ k i (el)
'xadra	(en) z a d ɹ ə (el)
koli'es	(en) k ɒ l ɪ z (el)
vraxi'oli	(en) v i ɹ a k s ɪ  ɒ l i (el)
ðaxti'liði	(en) ð a k s t ɪ l ɪ ð i (el)
'vera	(en) v iə ɹ ə (el)
bi'zu	(en) b ɪ z u (el)
sto'liði	(en) s t ɒ l ɪ ð i (el)
para'mana	(en) p a ɹ ə m ɑ n ə (el)
ku'bi	(en) k ʌ b aɪ (el)
'tsepi	(en) t s ɛ p i (el)
'velo	(en) v i l əʊ (el)
'ɣadi	 (en) ɡ a m ə  eɪ d i  aɪ (el)
'zoni	(en) z əʊ n i (el)
lu'riða	(en) l ʌ ɹ ɪ ð ə (el)
ka'pelo	(en) k a p i l əʊ (el)
tsa'garis	(en) t s a ɡ ɑ ɹ ɪ s (el)
'bota	(en) b əʊ t ə (el)
kal'son	(en) k a l s ə n (el)
'kaltsa	(en) k a l t s ə (el)
pade'loni	(en) p eɪ d l əʊ n i (el)
'fusta	(en) f ʌ s t ə (el)
'fusta	(en) f ʌ s t ə (el)
ɣia'kas	 (en) ɡ a m ə  aɪ eɪ  k w əʊ t k eɪ eɪ ɛ s (el)
pu'kamiso	(en) p ʌ k ɐ m aɪ z əʊ (el)
pal'to	(en) p a l t əʊ (el)
pano'fori	(en) p a n ə f ɔ ɹ i (el)
'forema	(en) f ɔ m ə (el)
fu'stani	(en) f ʌ s t ə n i (el)
'pontso	(en) p ɒ n t s əʊ (el)
'vafo	(en) v ɑ f əʊ (el)
'kapa	(en) k ɑ p ə (el)
klo'sti	(en) k l ɒ s t i (el)
ve'lona	(en) v ɛ l əʊ n ə (el)
su'vli	(en) s ʌ v l i (el)
'ravo	(en) ɹ ɑ v əʊ (el)
arɣa'lios	(en) eɪ ɑ  ɡ a m ə  eɪ  k w əʊ t ɛ l aɪ əʊ ɛ s (el)
i'feno	(en) aɪ f i n əʊ (el)
a'ðraxti	(en) a ð ɹ ɐ k s t i (el)
'kloθo	(en) k l əʊ (el) θ i t a (en) əʊ (el)
'ɣneθo	(en) ɡ a m ə  ɛ n i (el) θ i t a (en) əʊ (el)
'ðerma	(en) ð ɜ m ə (el)
'ɣuna	 (en) ɡ a m ə  j u ɛ n eɪ (el)
'tsoxa	(en) t s ɒ k s ə (el)
me'taksi	(en) m ɛ t ɐ k s i (el)
vam'vaki	(en) v a m v a k i (el)
li'nari	(en) l ɪ n ɑ ɹ i (el)
li'no	(en) l ɪ n əʊ (el)
ma'li	(en) m a l i (el)
'ifasma	(en) ɪ f a z m ə (el)
'raftis	(en) ɹ a f t i z (el)
'ruxo	(en) ɹ ʌ k s əʊ (el)
'enðima	(en) ɛ n ð ɪ m ə (el)
fo'rao	(en) f ɒ ɹ aʊ (el)
'dinome	(en) d ɪ n əʊ m (el)
a'vɣo	(en) eɪ  k w əʊ t v i  ɡ a m ə  əʊ (el)
'bira	(en) b iə ɹ ə (el)
iðro'meli	(en) ɪ ð ɹ ə m ɛ l i (el)
po'to	(en) p ɒ t əʊ (el)
'vutiro	(en) v j u t iə ɹ əʊ (el)
ti'ri	(en) t ɪ ɹ i (el)
ar'meɣo	(en) eɪ ɑ  k w əʊ t ɛ m i  ɡ a m ə  əʊ (el)
'zaxari	(en) z a k s ɑ ɹ i (el)
'ɣala	 (en) ɡ a m ə  eɪ ɛ l eɪ (el)
'meli	(en) m ɛ l i (el)
pi'peri	(en) p ɪ p ə ɹ i (el)
a'lati	(en) a l ɑ t i (el)
'lipos	(en) l i p əʊ z (el)
'ksigi	(en) k eɪ s ɪ ɡ ɪ (el)
'laði	(en) l a ð i (el)
eli'a	(en) ɪ l ɪ  ə (el)
sta'fili	(en) s t a f ɪ l i (el)
ka'riði	(en) k a ɹ ɪ ð i (el)
'siko	(en) s i k əʊ (el)
'matso	(en) m a t s əʊ (el)
ma'tsaki	(en) m a t s a k i (el)
'fruto	(en) f ɹ u t əʊ (el)
[pa'tata]	  (en) p a t ɑ t ə (el)
fa'soli	(en) f a s ə l i (el)
laxani'ka	(en) l a k s ɐ n ɪ k ə (el)
'supa	(en) s u p ə (el)
lu'kaniko	(en) l ʌ k ɐ n ɪ k əʊ (el)
'kreas	(en) k ɹ iə z (el)
ɣuðo'xeri	 (en) ɡ a m ə  j u ɛ ð əʊ  k w əʊ t ɛ k s i  ɑ ɹ aɪ (el)
ɣu'ði	 (en) ɡ a m ə  j u  k w əʊ t ɛ ð aɪ (el)
'milos	(en) m aɪ l əʊ z (el)
li'ono	(en) l ɪ  əʊ n əʊ (el)
a'leθo	(en) a l (el) θ i t a (en) əʊ (el)
a'levri	(en) a l ɪ v ɹ i (el)
zi'mono	(en) z ɪ m əʊ n əʊ (el)
'zimi	(en) z ɪ m i (el)
zi'mari	(en) z ɪ m ə ɹ i (el)
pso'mi	(en) s ɒ m i (el)
anaka'tevo	(en) a n ɐ k ɐ t i v əʊ (el)
'trivo	(en) t ɹ aɪ v əʊ (el)
koski'nizo	(en) k ɒ s k ɪ n ɪ z əʊ (el)
su'rono	(en) s ʌ ɹ əʊ n əʊ (el)
kseflu'ðizo	(en) k eɪ s ɛ f l ə ð ɪ z əʊ (el)
kaθa'rizo	(en) k ɑ (el) θ i t a (en) a ɹ ɪ z əʊ (el)
'ðipno	(en) ð ɪ p n əʊ (el)
vraði'no	(en) v i ɹ a ð ɪ n əʊ (el)
'ðipno	(en) ð ɪ p n əʊ (el)
vraði'no	(en) v i ɹ a ð ɪ n əʊ (el)
'ɣefma	 (en) ɡ a m ə  i  ɛ f ɛ m eɪ (el)
mesimeria'no	(en) m ɛ s ɪ m iə ɹ ɪ  a n əʊ (el)
proi'no	(en) p ɹ ɔɪ n əʊ (el)
faɣi'to	(en) ɛ f eɪ  ɡ a m ə  aɪ  k w əʊ t t i  əʊ (el)
fa'i	(en) f a i (el)
tsi'biða	(en) t s ɪ b ɪ ð ə (el)
la'viða	(en) l a v ɪ ð ə (el)
pi'runi	(en) p ɪ ɹ u n i (el)
ma'xeri	(en) m a k s ə ɹ i (el)
ku'tali	(en) k ʌ t ɑ l i (el)
pia'taki	(en) p aɪ ə t a k i (el)
fli'tzani	(en) f l ɪ t s ɑ n ɪ (el)
'kupa	(en) k j u p ə (el)
'bol	(en) b ɒ l (el)
'stamna	(en) s t a m n ə (el)
'piato	(en) p aɪ ə t əʊ (el)
'piato	(en) p aɪ ə t əʊ (el)
katsa'rola	(en) k a t s ɐ ɹ əʊ l ə (el)
katsa'rola	(en) k a t s ɐ ɹ əʊ l ə (el)
vra'stiras	(en) v i ɹ a s t iə ɹ ə z (el)
'furnos	(en) f ɜ n əʊ z (el)
'psino	(en) s i n əʊ (el)
tiɣa'nizo	(en) t i  aɪ  ɡ a m ə  eɪ  k w əʊ t ɛ n aɪ z ɛ d əʊ (el)
'vrazo	(en) v i ɹ ɑ z əʊ (el)
'psino	(en) s i n əʊ (el)
maɣi'revo	(en) ɛ m eɪ  ɡ a m ə  aɪ  k w əʊ t ɑ ɹ i v i  əʊ (el)
'pniɣome	(en) p i p i  ɛ n aɪ  ɡ a m ə  əʊ ɛ m i (el)
kata'pino	(en) k a t ɐ p i n əʊ (el)
ma'sao	(en) m a s aʊ (el)
'ɣlifo	(en) ɡ a m ə  l i f əʊ (el)
'ðipsa	(en) ð ɪ p s ə (el)
'pina	(en) p i n ə (el)
li'mos	(en) l ɪ m əʊ z (el)
'pina	(en) p i n ə (el)
'pino	(en) p i n əʊ (el)
'sapios	(en) s a p ɪ  əʊ z (el)
'aɣuros	(en) eɪ  ɡ a m ə  j u ɑ ɹ əʊ ɛ s (el)
'orimos	(en) ɒ ɹ ɪ m əʊ z (el)
o'mos	(en) əʊ m ɒ s (el)
psi'menos	(en) s ɪ m i n əʊ z (el)
tro'fi	(en) t ɹ ɒ f i (el)
'troo	(en) t ɹ u (el)
ɣi'mnos	 (en) ɡ a m ə  aɪ  k w əʊ t ɛ m ɛ n əʊ ɛ s (el)
ti'flos	(en) t ɪ f l əʊ z (el)
mu'gos	(en) m ʌ ɡ əʊ z (el)
ku'fos	(en) k ʌ f əʊ z (el)
fala'kros	(en) f a l a k ɹ əʊ z (el)
ku'tsos	(en) k ʌ t s əʊ z (el)
te'belis	(en) t ɛ b ɪ l i z (el)
kseku'razome	(en) k eɪ s ɛ k ə ɹ a z əʊ m (el)
'kura'smenos	(en) k j ʊ ɹ ɐ s m i n əʊ z (el)
ðili'tirio	(en) ð ɪ l ɪ t ɪ ɹ ɪ  əʊ (el)
'farmako	(en) f ɑ m ɑ k əʊ (el)
iatri'ki	(en) aɪ  ɐ t ɹ ɪ k i (el)
ɣia'tros	 (en) ɡ a m ə  aɪ eɪ  k w əʊ t t i  ɑ ɹ əʊ ɛ s (el)
ia'tros	(en) aɪ  a t ɹ əʊ z (el)
θera'pevome	θ i t a (en) ɪ ɹ a p ɪ v əʊ m (el)
ɣia'trevome	 (en) ɡ a m ə  aɪ eɪ  k w əʊ t t i  ɑ ɹ i v i  əʊ ɛ m i (el)
u'li	(en) ʌ l i (el)
'pion	(en) p ɪ  ɒ n (el)
ka'loɣiros	(en) k eɪ eɪ  k w əʊ t ɛ l əʊ  ɡ a m ə  aɪ  ɑ ɹ əʊ ɛ s (el)
fu'skala	(en) f ʌ s k ɑ l ə (el)
fa'ɣura	(en) ɛ f eɪ  k w əʊ t  ɡ a m ə  j u ɑ ɹ eɪ (el)
ka'bura	(en) k a b j ʊə ɹ ə (el)
'priksimo	(en) p ɹ ɪ k s ɪ m əʊ (el)
melani'a	(en) m ɛ l ɐ n ɪ  ə (el)
'molopas	(en) m ə l əʊ p ə z (el)
pli'ɣi	(en) p i  ɛ l aɪ  k w əʊ t  ɡ a m ə  aɪ (el)
si'naxi	(en) s ɪ n ɐ k s i (el)
vronxo'kili	(en) v i ɹ ɒ ŋ k s ə k ɪ l i (el)
pire'tos	(en) p aɪə t əʊ z (el)
'arostos	(en) ɐ ɹ ɒ s t əʊ z (el)
asθe'nis	(en) a z (el) θ i t a (en) ɛ n i z (el)
a'rostia	(en) a ɹ ɒ s tʃ ə (el)
a'sθenia	(en) eɪ z (el) θ i t a (en) i n i  ə (el)
'nosos	(en) n əʊ s əʊ z (el)
i'ɣia	(en) aɪ  k w əʊ t  ɡ a m ə  aɪ eɪ (el)
iɣi'is	(en) aɪ  ɡ a m ə  aɪ  k w əʊ t aɪ ɛ s (el)
a'ðinamos	(en) a ð ɪ n ə m əʊ z (el)
a'nisxiros	(en) a n ɪ s k s iə ɹ əʊ z (el)
ðina'tos	(en) ð ɪ n a t əʊ z (el)
ɣe'ros	 (en) ɡ a m ə  i  k w əʊ t ɑ ɹ əʊ ɛ s (el)
isxi'ros	(en) ɪ s k s ɪ ɹ əʊ z (el)
'tafos	(en) t ɑ f əʊ z (el)
'θavo	θ i t a (en) ɑ v əʊ (el)
'ptoma	(en) t əʊ m ə (el)
sko'tono	(en) s k ə t əʊ n əʊ (el)
pniɣ'menos	(en) p i p i  ɛ n aɪ  ɡ a m ə   k w əʊ t ɛ m i  ɛ n əʊ ɛ s (el)
pe'θeno	(en) p ɛ θ i t ə  ɪ n əʊ (el)
peθa'menos	(en) p i (el) θ i t a (en) a m i n əʊ z (el)
ne'kros	(en) n ɛ k ɹ əʊ z (el)
'zo	(en) z əʊ (el)
zoda'nos	(en) z ə d a n əʊ z (el)
zo'i	(en) z ɒ i (el)
silam'vano	(en) s ɪ l ɐ m v ɑ n əʊ (el)
'egios	(en) ɛ dʒ ɪ  əʊ z (el)
ɣeni'menos	 (en) ɡ a m ə  i  ɛ n aɪ  k w əʊ t ɛ m i  ɛ n əʊ ɛ s (el)
ɣeni'eme	 (en) ɡ a m ə  i  ɛ n aɪ  k w əʊ t i  ɛ m i (el)
ɣe'nao	 (en) ɡ a m ə  i  k w əʊ t ɛ n eɪ əʊ (el)
anatrixi'azo	(en) a n eɪ t ɹ ɪ k s ɪ  ɑ z əʊ (el)
ri'ɣo	(en) ɑ ɹ aɪ  k w əʊ t  ɡ a m ə  əʊ (el)
ener'ɣume	(en) i  ɛ n i  ɑ  k w əʊ t  ɡ a m ə  j u ɛ m i (el)
ka'ka	(en) k a k ə (el)
ska'ta	(en) s k a t ə (el)
u'ro	(en) ʌ ɹ əʊ (el)
'klano	(en) k l ɑ n əʊ (el)
ksi'pnao	(en) k eɪ s ɪ p n aʊ (el)
oni'revome	(en) ɒ n ɪ ɹ ɛ v əʊ m (el)
roxa'lizo	(en) ɹ ɒ k s ɐ l ɪ z əʊ (el)
ki'mame	(en) k ɪ m eɪ m (el)
'ɣlifo	(en) ɡ a m ə  l i f əʊ (el)
ða'gono	(en) ð a ɡ əʊ n əʊ (el)
'ftino	(en) ɛ f t i n əʊ (el)
i'ðrono	(en) aɪ ð ɹ əʊ n əʊ (el)
ftar'nizome	(en) ɛ f t ɑ n ɪ z əʊ m (el)
'vixo	(en) v ɪ k s əʊ (el)
xasmu'rieme	(en) z a z m ə ɹ ɪ m (el)
ana'pneo	(en) a n ɐ p n eɪ əʊ (el)
anapno'i	(en) a n ɐ p n ɒ i (el)
'peos	(en) p ɪ  əʊ z (el)
'orxis	(en) ɔ k s ɪ s (el)
'mitra	(en) m ɪ t ɹ ə (el)
ɣlu'ti	(en) ɡ a m ə  l ʌ t i (el)
pisi'nos	(en) p ɪ s ɪ n əʊ z (el)
le'kani	(en) l ɛ k ɑ n ɪ (el)
'mesi	(en) m ɛ s i (el)
'edera	(en) ɛ d ə ɹ ə (el)
sto'maxi	(en) s t ɒ m ɐ k s i (el)
kili'a	(en) k ɪ l ɪ  ə (el)
'splina	(en) s p l i n ə (el)
ne'fro	(en) n ɛ f ɹ əʊ (el)
si'koti	(en) s ɪ k əʊ t i (el)
kar'ðia	(en) k ɑ ð i  ə (el)
afa'los	(en) ɐ f a l əʊ z (el)
ma'stos	(en) m a s t əʊ z (el)
θi'li	θ i t a (en) aɪ l i (el)
'roɣa	(en) ɑ ɹ əʊ  ɡ a m ə  eɪ (el)
'stiθos	(en) s t aɪ (el) θ i t a (en) əʊ ɛ s (el)
'stiθi	(en) s t aɪ (el) θ i t a (en) aɪ (el)
'stiθos	(en) s t aɪ (el) θ i t a (en) əʊ ɛ s (el)
'θorakas	θ i t a (en) ɔ ɹ ɑ k ə z (el)
fte'ro	(en) ɛ f t ɛ ɹ əʊ (el)
fte'ro	(en) ɛ f t ɛ ɹ əʊ (el)
'xnari	(en) ɛ k s n ɑ ɹ i (el)
'ixnos	(en) ɪ k s n əʊ z (el)
'fterna	(en) ɛ f t ɜ n ə (el)
a'straɣalos	(en) eɪ  k w əʊ t ɛ s t i  ɑ ɹ eɪ  ɡ a m ə  eɪ ɛ l əʊ ɛ s (el)
'poði	(en) p əʊ ð i (el)
'ɣonato	 (en) ɡ a m ə  əʊ ɛ n eɪ t i  əʊ (el)
'ɣaba	 (en) ɡ a m ə  eɪ b i  eɪ (el)
'buti	(en) b j u t i (el)
mi'ros	(en) m ɪ ɹ əʊ z (el)
'poði	(en) p əʊ ð i (el)
'nixi	(en) n ɪ k s i (el)
'nixi	(en) n ɪ k s i (el)
a'dixiras	(en) a d ɪ k s iə ɹ ə z (el)
'ðaxtilo	(en) ð a k s t ɪ l əʊ (el)
pa'lami	(en) p a l ɑ m i (el)
'xeri	(en) z ɛ ɹ i (el)
a'gonas	(en) a ɡ əʊ n ə z (el)
(a)ma'sxali	  (en) eɪ (el)   (en) m a s k s ɑ l i (el)
'xeri	(en) z ɛ ɹ i (el)
'sterno	(en) s t ɜ n əʊ (el)
omo'plati	(en) ɒ m ə p l ɑ t i (el)
'omos	(en) əʊ m əʊ z (el)
le'mos	(en) l ɛ m əʊ z (el)
la'rigi	(en) l a ɹ ɪ ɡ ɪ (el)
le'mos	(en) l ɛ m əʊ z (el)
'ðodi	(en) ð əʊ d ɪ (el)
'ula	(en) u l ə (el)
'ɣlosa	(en) ɡ a m ə  l əʊ s ə (el)
'xili	(en) z ɪ l i (el)
'ramfos	(en) ɹ a m f əʊ z (el)
'stoma	(en) s t əʊ m ə (el)
'miksa	(en) m ɪ k s ə (el)
ru'θuni	(en) ɹ ʌ θ i t ə  j u n i (el)
'miti	(en) m i t i (el)
ke'ri	(en) k ɛ ɹ i (el)
lo'vos	(en) l ɒ v əʊ z (el)
a'fti	(en) a f t i (el)
vlefa'riða	(en) v i l ɛ f ɐ ɹ ɪ ð ə (el)
ma'toklaðo	(en) m a t ə k l ɑ ð əʊ (el)
'vlefaro	(en) v i l ɛ f a ɹ əʊ (el)
'friði	(en) f ɹ ɪ ð i (el)
'mati	(en) m a t i (el)
'maɣulo	(en) ɛ m eɪ  ɡ a m ə  j u ɛ l əʊ (el)
pi'ɣuni	(en) p i  aɪ  k w əʊ t  ɡ a m ə  j u ɛ n aɪ (el)
sa'ɣoni	(en) ɛ s eɪ  k w əʊ t  ɡ a m ə  əʊ ɛ n aɪ (el)
'metopo	(en) m ɛ t əʊ p əʊ (el)
'kutelo	(en) k j u t i l əʊ (el)
ma'sela	(en) m a s ɛ l ə (el)
'prosopo	(en) p ɹ ə s əʊ p əʊ (el)
'mutra	(en) m ʌ t ɹ ə (el)
mia'lo	(en) m aɪ ə l əʊ (el)
'nus	(en) n ʌ s (el)
e'gefalos	(en) ɛ dʒ ɪ f ə l əʊ z (el)
'krotafos	(en) k ɹ əʊ t ɑ f əʊ z (el)
kra'nio	(en) k ɹ a n ɪ  əʊ (el)
ke'fali	(en) k ɛ f ɑ l i (el)
raxokokali'a	(en) ɹ a k s ə k ɒ k ɐ l ɪ  ə (el)
'plati	(en) p l a t i (el)
u'ra	(en) ʌ ɹ ə (el)
'kerato	(en) k ə ɹ ɑ t əʊ (el)
ple'vro	(en) p l ɛ v ɹ əʊ (el)
'kokalo	(en) k əʊ k ə l əʊ (el)
'fleva	(en) f l ɛ v ə (el)
arti'ria	(en) ɑ t ɪ ɹ iə (el)
'ema	(en) ɪ m a (el)
piti'riða	(en) p ɪ t ɪ ɹ ɪ ð ə (el)
'trixa	(en) t ɹ ɪ k s ə (el)
'trixa	(en) t ɹ ɪ k s ə (el)
'musi	(en) m j u s i (el)
'ɣenia	 (en) ɡ a m ə  i  ɛ n aɪ eɪ (el)
'trixa	(en) t ɹ ɪ k s ə (el)
'sarka	(en) s ɑ k ə (el)
'ðerma	(en) ð ɜ m ə (el)
epiðer'miða	(en) ɛ p ɪ ð ə m ɪ ð ə (el)
'soma	(en) s əʊ m ə (el)
kor'mi	(en) k ɔ m i (el)
xe'lona	(en) z ɛ l əʊ n ə (el)
kro'koðilos	(en) k ɹ ɒ k ə ð ɪ l əʊ z (el)
ali'ɣatoras	(en) eɪ ɛ l aɪ  k w əʊ t  ɡ a m ə  eɪ t i  əʊ ɑ ɹ eɪ ɛ s (el)
'savra	(en) s a v ɹ ə (el)
'vatraxos	(en) v a t ɹ a k s əʊ z (el)
sali'gari	(en) s a l ɪ ɡ ɑ ɹ i (el)
a'kriða	(en) a k ɹ ɪ ð ə (el)
peta'luða	(en) p ɛ t ɐ l u ð ə (el)
piɣola'biða	(en) p i  aɪ  ɡ a m ə  əʊ ɛ l eɪ  k w əʊ t b i  aɪ ɛ ð eɪ (el)
'fiði	(en) f ɪ ð i (el)
sku'liki	(en) s k ʌ l ɪ k i (el)
ku'nupi	(en) k ʌ n j u p i (el)
ku'nupi	(en) k ʌ n j u p i (el)
mi'ɣaki	(en) ɛ m aɪ  k w əʊ t  ɡ a m ə  eɪ k eɪ aɪ (el)
'miɣa	(en) ɛ m aɪ  ɡ a m ə  eɪ (el)
'sfiga	(en) ɛ s f i ɡ ə (el)
ki'pseli	(en) k ɪ p s ɪ l i (el)
ke'ri	(en) k ɛ ɹ i (el)
'melisa	(en) m ɛ l ɪ s ə (el)
a'raxni	(en) a ɹ ɐ k s n i (el)
mir'migi	(en) m ɜ m ɪ ɡ ɪ (el)
katsa'riða	(en) k a t s ɐ ɹ ɪ ð ə (el)
skor'pios	(en) s k ɔ p ɪ  əʊ z (el)
saradapoða'rusa	(en) s a ɹ ɐ d a p ə ð a ɹ u s ə (el)
'psilos	(en) s i l əʊ z (el)
'koniða	(en) k ɒ n ɪ ð ə (el)
'psira	(en) s iə ɹ ə (el)
'edomo	(en) ɛ d əʊ m əʊ (el)
ka'mila	(en) k a m ɪ l ə (el)
e'lefadas	(en) ɛ l ɪ f ɑ d ə z (el)
'piθikos	(en) p aɪ (el) θ i t a (en) aɪ k əʊ z (el)
mai'mu	(en) m eɪ m u (el)
e'lafi	(en) ɛ l ɐ f i (el)
zar'kaði	(en) z ɑ k ɐ ð i (el)
ale'pu	(en) ɐ l ɛ p u (el)
ar'kuða	(en) ɑ k j u ð ə (el)
lio'dari	(en) l ɪ  ə d ɑ ɹ i (el)
'likos	(en) l i k əʊ z (el)
'xeli	(en) z ɛ l i (el)
sa'laxi	(en) s a l ɐ k s i (el)
'falena	(en) f eɪ l n ə (el)
ðel'fini	(en) ð ɛ l f i n ɪ (el)
karxa'rias	(en) k ɑ k s a ɹ iə z (el)
'ostrako	(en) ɒ s t ɹ ɑ k əʊ (el)
ko'xili	(en) k ɒ k s ɪ l i (el)
'vranxia	(en) v i ɹ a ŋ k s i  ə (el)
'lepi	(en) l ɛ p i (el)
pte'riɣio	(en) p i t i  i  k w əʊ t ɑ ɹ aɪ  ɡ a m ə  aɪ əʊ (el)
'psari	(en) s ɑ ɹ i (el)
po'diki	(en) p ɒ d ɪ k i (el)
aru'reos	(en) a ɹ ə ɹ ɪ  əʊ z (el)
o'posum	(en) əʊ p ɒ s ə m (el)
'ɣata	 (en) ɡ a m ə  eɪ t i  eɪ (el)
ku'neli	(en) k ʌ n ɪ l i (el)
'skilos	(en) s k i l əʊ z (el)
ski'li	(en) s k ɪ l i (el)
peri'steri	(en) p ɛ ɹ ɪ s t ə ɹ i (el)
kuku'vaɣia	(en) k eɪ j u k eɪ j u  k w əʊ t v i  eɪ  ɡ a m ə  aɪ eɪ (el)
ko'raki	(en) k ə ɹ a k i (el)
'korakas	(en) k ɔ ɹ ɑ k ə z (el)
papa'ɣalos	(en) p i  eɪ p i  eɪ  k w əʊ t  ɡ a m ə  eɪ ɛ l əʊ ɛ s (el)
nixte'riða	(en) n ɪ k s t ɪ ɹ ɪ ð ə (el)
'ɣipas	 (en) ɡ a m ə  aɪ p i  eɪ ɛ s (el)
ɣe'raki	 (en) ɡ a m ə  i  k w əʊ t ɑ ɹ eɪ k eɪ aɪ (el)
ae'tos	(en) i t əʊ z (el)
'ɣlaros	(en) ɡ a m ə  l a ɹ əʊ z (el)
eroði'os	(en) ɪ ɹ ɒ ð ɪ  əʊ z (el)
pu'li	(en) p ʌ l i (el)
fo'lia	(en) f ɒ l i  ə (el)
'papia	(en) p eɪ p i  ə (el)
'xina	(en) z i n ə (el)
ko'topulo	(en) k ɒ t ə p j ʊ l əʊ (el)
'kota	(en) k əʊ t ə (el)
'kokoras	(en) k ɒ k ɔ ɹ ə z (el)
mu'lari	(en) m ʌ l ɑ ɹ i (el)
puleri'ko	(en) p j ʊ l ə ɹ ɪ k əʊ (el)
ɣai'ðuri	 (en) ɡ a m ə  eɪ aɪ  k w əʊ t ɛ ð j u ɑ ɹ aɪ (el)
'ɣaiðaros	 (en) ɡ a m ə  eɪ aɪ ɛ ð eɪ ɑ ɹ əʊ ɛ s (el)
pu'lari	(en) p ʌ l ɑ ɹ i (el)
fo'raða	(en) f ə ɹ ɑ ð ə (el)
'aloɣo	(en) eɪ ɛ l əʊ  ɡ a m ə  əʊ (el)
'ipos	(en) aɪ p əʊ z (el)
ka'tsiki	(en) k a t s ɪ k i (el)
katsi'kaki	(en) k a t s ɪ k a k i (el)
'traɣos	(en) t i  ɑ ɹ eɪ  ɡ a m ə  əʊ ɛ s (el)
ka'tsika	(en) k a t s ɪ k ə (el)
'ɣiða	 (en) ɡ a m ə  aɪ ɛ ð eɪ (el)
ɣu'runi	 (en) ɡ a m ə  j u  k w əʊ t ɑ j u ɛ n aɪ (el)
ɣu'runa	 (en) ɡ a m ə  j u  k w əʊ t ɑ j u ɛ n eɪ (el)
aɣrio'ɣuruno	(en) eɪ  ɡ a m ə  ɑ ɹ aɪ əʊ  k w əʊ t  ɡ a m ə  j u ɑ j u ɛ n əʊ (el)
ar'ni	(en) ɑ n i (el)
prova'tina	(en) p ɹ ɒ v ɐ t i n ə (el)
kri'ari	(en) k ɹ ɪ  ɑ ɹ i (el)
'provato	(en) p ɹ ə v ɑ t əʊ (el)
mo'sxari	(en) m ə s k s ɑ ɹ i (el)
aɣe'laða	(en) eɪ  ɡ a m ə  i  k w əʊ t ɛ l eɪ ɛ ð eɪ (el)
'voði	(en) v əʊ ð i (el)
'tavros	(en) t a v ɹ əʊ z (el)
'zoa	(en) z əʊ ə (el)
zoda'na	(en) z ɒ d a n ə (el)
'stavlos	(en) s t a v l əʊ z (el)
vo'skos	(en) v ɒ s k əʊ z (el)
vosko'topi	(en) v ɒ s k ə t əʊ p i (el)
'zoa	(en) z əʊ ə (el)
zoda'na	(en) z ɒ d a n ə (el)
θili'kos	θ i t a (en) ɪ l ɪ k əʊ z (el)
arseni'kos	(en) ɑ s ə n ɪ k əʊ z (el)
'zoo	(en) z u (el)
a'fti	(en) a f t i (el)
a'ftes	(en) a f t s (el)
a'fta	(en) a f t ə (el)
e'sis	(en) ɛ s i z (el)
e'mis	(en) ɛ m i z (el)
e'mis	(en) ɛ m i z (el)
e'mis	(en) ɛ m i z (el)
a'ftos	(en) a f t əʊ z (el)
a'fti	(en) a f t i (el)
a'fto	(en) a f t əʊ (el)
e'si	(en) ɛ s i (el)
e'ɣo	(en) i  k w əʊ t  ɡ a m ə  əʊ (el)
iko'ɣenia	(en) aɪ k eɪ əʊ  k w əʊ t  ɡ a m ə  i  ɛ n aɪ eɪ (el)
sige'nis	(en) s aɪ dʒ n i z (el)
'soi	(en) s ɔɪ (el)
'xiros	(en) z aɪ ɹ əʊ z (el)
'xira	(en) z iə ɹ ə (el)
orfa'nos	(en) ɔ f a n əʊ z (el)
orfa'ni	(en) ɔ f ɐ n i (el)
proɣo'ni	(en) p i  ɑ ɹ əʊ  ɡ a m ə  əʊ  k w əʊ t ɛ n aɪ (el)
proɣo'nos	(en) p i  ɑ ɹ əʊ  ɡ a m ə  əʊ  k w əʊ t ɛ n əʊ ɛ s (el)
mitri'a	(en) m ɪ t ɹ ɪ  ə (el)
patri'os	(en) p a t ɹ ɪ  əʊ z (el)
'nifi	(en) n ɪ f i (el)
'nifi	(en) n ɪ f i (el)
ɣa'bros	 (en) ɡ a m ə  eɪ  k w əʊ t b i  ɑ ɹ əʊ ɛ s (el)
ɣa'bros	 (en) ɡ a m ə  eɪ  k w əʊ t b i  ɑ ɹ əʊ ɛ s (el)
peθe'ra	(en) p i (el) θ i t a (en) ɛ ɹ ə (el)
peθe'ra	(en) p i (el) θ i t a (en) ɛ ɹ ə (el)
peθe'ros	(en) p i (el) θ i t a (en) ɛ ɹ əʊ z (el)
peθe'ros	(en) p i (el) θ i t a (en) ɛ ɹ əʊ z (el)
a'poɣoni	(en) eɪ  k w əʊ t p i  əʊ  ɡ a m ə  əʊ ɛ n aɪ (el)
'proɣoni	(en) p i  ɑ ɹ əʊ  ɡ a m ə  əʊ ɛ n aɪ (el)
(e)'ksaðerfos	  (en) i (el)   (en) k eɪ s a ð ə f əʊ z (el)
(e)ksa'ðerfi	  (en) i (el)   (en) k eɪ s a ð ə f i (el)
ani'psia	(en) a n ɪ p s iə (el)
ani'psios	(en) a n ɪ p s ɪ  əʊ z (el)
'θia	θ i t a (en) aɪ ə (el)
'θios	θ i t a (en) aɪ əʊ ɛ s (el)
ego'nos	(en) i ɡ əʊ n əʊ z (el)
ego'ni	(en) i ɡ əʊ n i (el)
ɣri'a	(en) ɡ a m ə  ɹ ɪ  ə (el)
ɣia'ɣia	 (en) ɡ a m ə  aɪ eɪ  k w əʊ t  ɡ a m ə  aɪ eɪ (el)
'ɣeros	 (en) ɡ a m ə  i  ɑ ɹ əʊ ɛ s (el)
pa'pus	(en) p a p ə s (el)
'ðiðimi	(en) ð ɪ ð ɪ m i (el)
'ðiðima	(en) ð ɪ ð ɪ m ə (el)
aðer'fos	(en) eɪ ð r f əʊ z (el)
aðer'fi	(en) eɪ ð r f i (el)
aðer'fi	(en) eɪ ð r f i (el)
aðer'fos	(en) eɪ ð r f əʊ z (el)
pe'ði	(en) p ɛ ð i (el)
'kori	(en) k ɔ ɹ i (el)
'ɣios	 (en) ɡ a m ə  aɪ əʊ ɛ s (el)
padre'meni	(en) p a d ɹ ɪ m ə n i (el)
padre'menos	(en) p a d ɹ ɪ m i n əʊ z (el)
ɣo'nis	 (en) ɡ a m ə  əʊ  k w əʊ t ɛ n aɪ ɛ s (el)
mi'tera	(en) m ɪ t ə ɹ ə (el)
ma'ma	(en) m a m ə (el)
'mana	(en) m ɑ n ə (el)
pa'teras	(en) p a t ə ɹ ə z (el)
ba'bas	(en) b a b ə z (el)
ðia'ziɣio	(en) ɛ ð aɪ eɪ  k w əʊ t z ɛ d aɪ  ɡ a m ə  aɪ əʊ (el)
'ɣamos	 (en) ɡ a m ə  eɪ ɛ m əʊ ɛ s (el)
pa'drevome	(en) p a d ɹ ɪ v əʊ m (el)
'siziɣos	(en) ɛ s aɪ z ɛ d aɪ  ɡ a m ə  əʊ ɛ s (el)
ɣi'neka	 (en) ɡ a m ə  aɪ  k w əʊ t ɛ n i k eɪ eɪ (el)
'siziɣos	(en) ɛ s aɪ z ɛ d aɪ  ɡ a m ə  əʊ ɛ s (el)
'adras	(en) ɐ d ɹ a z (el)
pe'ði	(en) p ɛ ð i (el)
mo'ro	(en) m ɒ ɹ əʊ (el)
pe'ði	(en) p ɛ ð i (el)
ko'ritsi	(en) k ə ɹ ɪ t s i (el)
ko'pela	(en) k ə p ɛ l ə (el)
'efivi	(en) ɛ f ɪ v i (el)
ko'ritsi	(en) k ə ɹ ɪ t s i (el)
a'ɣori	(en) eɪ  k w əʊ t  ɡ a m ə  əʊ ɑ ɹ aɪ (el)
nea'ros	(en) n i ɹ əʊ z (el)
'efivi	(en) ɛ f ɪ v i (el)
a'ɣori	(en) eɪ  k w əʊ t  ɡ a m ə  əʊ ɑ ɹ aɪ (el)
θili'kos	θ i t a (en) ɪ l ɪ k əʊ z (el)
arseni'kos	(en) ɑ s ə n ɪ k əʊ z (el)
ɣi'neka	 (en) ɡ a m ə  aɪ  k w əʊ t ɛ n i k eɪ eɪ (el)
'adras	(en) ɐ d ɹ a z (el)
'anθropos	(en) ɐ n (el) θ i t a (en) ɹ əʊ p əʊ z (el)
'on	(en) ɒ n (el)
'atomo	(en) a t əʊ m əʊ (el)
'karvuno	(en) k ɑ v u n əʊ (el)
ksilo'karvuno	(en) k eɪ s aɪ l ə k ɑ v u n əʊ (el)
'ksilo	(en) k eɪ s aɪ l əʊ (el)
pro'sanama	(en) p ɹ ɒ s ɐ n ɑ m ə (el)
'spirto	(en) s p ɜ t əʊ (el)
a'navo	(en) a n ɑ v əʊ (el)
'keo	(en) k i  əʊ (el)
'keɣome	(en) k eɪ i  ɡ a m ə  əʊ ɛ m i (el)
'keo	(en) k i  əʊ (el)
'xovoli	(en) z ɒ v ə l i (el)
'θraka	θ i t a (en) ɹ ɑ k ə (el)
'karvuno	(en) k ɑ v u n əʊ (el)
'staxti	(en) s t a k s t i (el)
ka'pnos	(en) k a p n əʊ z (el)
'floɣa	(en) ɛ f ɛ l əʊ  ɡ a m ə  eɪ (el)
fo'tia	(en) f ɒ ʃ ə (el)
ke'ros	(en) k ɛ ɹ əʊ z (el)
'paɣos	(en) p i  eɪ  ɡ a m ə  əʊ ɛ s (el)
paɣe'tos	(en) p i  eɪ  ɡ a m ə  i  k w əʊ t t i  əʊ ɛ s (el)
'xioni	(en) k ʃ ə n i (el)
vro'xi	(en) v i ɹ ɒ k s i (el)
'pusi	(en) p j u s i (el)
o'mixli	(en) əʊ m ɪ k s l i (el)
a'eras	(en) a ə ɹ ə z (el)
'anemos	(en) ɐ n i m əʊ z (el)
'sinefo	(en) s aɪ n f əʊ (el)
a'eras	(en) a ə ɹ ə z (el)
ðro'sos	(en) d ɹ ɒ s əʊ z (el)
ðro'sia	(en) d ɹ ɒ z iə (el)
ski'a	(en) s k ɪ  ə (el)
sko'taði	(en) s k ɒ t ɐ ð i (el)
'fos	(en) f ɒ s (el)
kate'ɣiða	(en) k eɪ eɪ t i  i  k w əʊ t  ɡ a m ə  aɪ ɛ ð eɪ (el)
'θiela	θ i t a (en) i  ɛ l ə (el)
anemo'θiela	(en) ɐ n ɛ m ə θ i t ə  i  ɛ l ə (el)
vro'di	(en) v i ɹ ɒ d ɪ (el)
bubuni'to	(en) b j u b j u n ɪ t əʊ (el)
kerav'nos	(en) k ə ɹ a v n əʊ z (el)
astra'pi	(en) ɐ s t ɹ a p i (el)
a'steri	(en) a s t ə ɹ i (el)
'astro	(en) a s t ɹ əʊ (el)
fe'gari	(en) f ɛ ɡ ɑ ɹ i (el)
se'lini	(en) s ɛ l i n ɪ (el)
'ilios	(en) ɪ l ɪ  əʊ z (el)
ura'nos	(en) j ʊə ɹ a n əʊ z (el)
'petra	(en) p ɛ t ɹ ə (el)
'vraxos	(en) v i ɹ a k s əʊ z (el)
'ksilo	(en) k eɪ s aɪ l əʊ (el)
'ðedro	(en) ð ɛ d ɹ əʊ (el)
'ðasos	(en) ð ɑ s əʊ z (el)
kata'raxtis	(en) k a t ɐ ɹ a k s t i z (el)
'valtos	(en) v ɒ l t əʊ z (el)
'elos	(en) ɪ l əʊ z (el)
pi'ɣi	(en) p i  aɪ  k w əʊ t  ɡ a m ə  aɪ (el)
pi'ɣaði	(en) p i  aɪ  k w əʊ t  ɡ a m ə  eɪ ɛ ð aɪ (el)
'ðini	(en) ð ɪ n i (el)
po'tami	(en) p ə t ɑ m i (el)
pota'mos	(en) p ə t a m əʊ z (el)
pa'liria	(en) p a l ɪ ɹ iə (el)
'aboti	(en) ɐ b əʊ t i (el)
pa'liria	(en) p a l ɪ ɹ iə (el)
akro'tiri	(en) a k ɹ ə t iə ɹ i (el)
'kavos	(en) k ɑ v əʊ z (el)
'ifalos	(en) ɪ f ə l əʊ z (el)
'skopelos	(en) s k ɒ p i l əʊ z (el)
limno'θalasa	(en) l ɪ m n ə θ i t ə  ɐ l ɑ s ə (el)
'kolpos	(en) k ɒ l p əʊ z (el)
kol'piskos	(en) k ə l p ɪ s k əʊ z (el)
'limni	(en) l ɪ m n i (el)
triki'mia	(en) t ɹ aɪ k ɪ m iə (el)
θalasotara'xi	θ i t a (en) ɐ l a s ə t a ɹ ɐ k s i (el)
'θalasa	θ i t a (en) ɐ l ɑ s ə (el)
nine'mia	(en) n aɪ n m i  ə (el)
ne'ro	(en) n ɛ ɹ əʊ (el)
spi'lia	(en) s p ɪ l i  ə (el)
a'kti	(en) a k t i (el)
para'lia	(en) p a ɹ ə l iə (el)
ɣia'los	 (en) ɡ a m ə  aɪ eɪ  k w əʊ t ɛ l əʊ ɛ s (el)
'ipiros	(en) ɪ p iə ɹ əʊ z (el)
ste'ria	(en) s t ɛ ɹ i  ə (el)
ni'si	(en) n ɪ s i (el)
'nisos	(en) n aɪ z əʊ z (el)
peði'aða	(en) p ɛ ð ɪ  ɑ ð ə (el)
ekso'xi	(en) ɛ k s ə k s i (el)
'ipeθros	(en) aɪ p (el) θ i t a (en) ɹ əʊ z (el)
'vraxos	(en) v i ɹ a k s əʊ z (el)
gre'mos	(en) ɡ ɹ ɛ m əʊ z (el)
vu'no	(en) v ʌ n əʊ (el)
'oros	(en) ɔ ɹ əʊ z (el)
'lofos	(en) l əʊ f əʊ z (el)
'laspi	(en) l a s p i (el)
'amos	(en) eɪ m ɒ s (el)
'skoni	(en) s k əʊ n i (el)
'ɣi	 (en) ɡ a m ə  aɪ (el)
'eðafos	(en) ɛ ð ɑ f əʊ z (el)
'xoma	(en) z əʊ m ə (el)
'ɣi	 (en) ɡ a m ə  aɪ (el)
'sidoma	(en) s ɪ d əʊ m ə (el)
po'te	(en) p ɒ t (el)
'pali	(en) p ɑ l i (el)
(i)'mera	  (en) aɪ (el)   (en) m iə ɹ ə (el)
'nixta	(en) n ɪ k s t ə (el)
a'vɣi	(en) eɪ  k w əʊ t v i  ɡ a m ə  aɪ (el)
pro'i	(en) p ɹ ɒ i (el)
mesi'meri	(en) m ɛ s ɪ m ə ɹ i (el)
a'poɣefma	(en) eɪ  k w əʊ t p i  əʊ  ɡ a m ə  i  ɛ f ɛ m eɪ (el)
'vraði	(en) v i ɹ a ð i (el)
'simera	(en) s aɪ m ɹ ə (el)
'avrio	(en) a v ɹ ɪ  əʊ (el)
me'θavrio	(en) m ɛ θ i t ə  a v ɹ ɪ  əʊ (el)
(e)'xtes	  (en) i (el)   (en) ɛ k s t ɛ s (el)
pro'xtes	(en) p ɹ ɒ k s t s (el)
'ora	(en) ɔ ɹ ə (el)
(o)ro'loi	  (en) əʊ (el)   (en) ɹ ɒ l ɔɪ (el)
(e)vðo'maða	  (en) i (el)   (en) v i ð ə m ɑ ð ə (el)
kiria'ki	(en) k ɪ ɹ ɪ  a k i (el)
ðe'ftera	(en) ð ɛ f t ə ɹ ə (el)
'triti	(en) t ɹ aɪ t i (el)
te'tarti	(en) t ɛ t ɑ t i (el)
'pempti	(en) p ɛ m p t i (el)
paraske'vi	(en) p a ɹ ə s k ɛ v i (el)
'savato	(en) s a v ɑ t əʊ (el)
'minas	(en) m i n ə z (el)
'xronos	(en) ɛ k s ɹ əʊ n əʊ z (el)
'etos	(en) i t əʊ z (el)
xro'nia	(en) ɛ k s ɹ ɒ n i  ə (el)
xi'monas	(en) z ɪ m əʊ n ə z (el)
'aniksi	(en) a n ɪ k s i (el)
kalo'keri	(en) k a l ə k ə ɹ i (el)
fθi'noporo	(en) ɛ f (el) θ i t a (en) aɪ n ə p ɔ ɹ əʊ (el)
epo'xi	(en) ɛ p ə k s i (el)
mi'rizo	(en) m ɪ ɹ ɪ z əʊ (el)
mi'rizome	(en) m ɪ ɹ ɪ z əʊ m (el)
mi'rizo	(en) m ɪ ɹ ɪ z əʊ (el)
miro'ðatos	(en) m ɪ ɹ ə ð ɑ t əʊ z (el)
aromati'smenos	(en) ɐ ɹ əʊ m ɐ t ɪ s m i n əʊ z (el)
vrome'ros	(en) v i ɹ əʊ m ɹ əʊ z (el)
ðoki'mazo	(en) ð ɒ k ɪ m ɑ z əʊ (el)
ɣli'kos	(en) ɡ a m ə  l ɪ k əʊ z (el)
mala'kos	(en) m a l a k əʊ z (el)
almi'ros	(en) ɒ l m ɪ ɹ əʊ z (el)
pi'kros	(en) p ɪ k ɹ əʊ z (el)
sti'fos	(en) s t ɪ f əʊ z (el)
ksi'nos	(en) k eɪ s ɪ n əʊ z (el)
ɣli'fos	(en) ɡ a m ə  l ɪ f əʊ z (el)
a'kuo	(en) a k j u əʊ (el)
a'kuo	(en) a k j u əʊ (el)
'ixos	(en) aɪ k s əʊ z (el)
'θorivos	θ i t a (en) ɒ ɹ ɪ v əʊ z (el)
fasa'ria	(en) f a s a ɹ iə (el)
θori'voðis	θ i t a (en) ɔ ɹ ɪ v əʊ ð i z (el)
ixi'ros	(en) ɪ k s ɪ ɹ əʊ z (el)
'isixos	(en) ɪ s ɪ k s əʊ z (el)
isi'xia	(en) ɪ s ɪ k s iə (el)
'vlepo	(en) v i l i p əʊ (el)
ki'tazo	(en) k ɪ t ɑ z əʊ (el)
'ðixno	(en) ð ɪ k s n əʊ (el)
'labo	(en) l ɑ b əʊ (el)
labe'ros	(en) l eɪ b ɹ əʊ z (el)
foti'nos	(en) f əʊ t ɪ n əʊ z (el)
zoi'ros	(en) z ɔɪ ɹ əʊ z (el)
'xroma	(en) ɛ k s ɹ əʊ m ə (el)
ani'xtos	(en) a n ɪ k s t əʊ z (el)
'skuros	(en) s k j ʊ ɹ əʊ z (el)
'aspros	(en) ɐ s p ɹ əʊ z (el)
lef'kos	(en) l ɛ f k əʊ z (el)
'mavros	(en) m a v ɹ əʊ z (el)
'kokinos	(en) k ə k i n əʊ z (el)
'ble	(en) b l i (el)
'prasinos	(en) p ɹ a s i n əʊ z (el)
'kitrinos	(en) k ɪ t ɹ i n əʊ z (el)
a'gizo	(en) a dʒ ɪ z əʊ (el)
tsi'bao	(en) t s ɪ b aʊ (el)
e'sθanome	(en) i z (el) θ i t a (en) ɐ n ɒ m (el)
'nioθo	(en) n i  əʊ (el) θ i t a (en) əʊ (el)
skli'ros	(en) s k l ɪ ɹ əʊ z (el)
apa'los	(en) ɐ p a l əʊ z (el)
mala'kos	(en) m a l a k əʊ z (el)
tra'xis	(en) t ɹ a k s ɪ s (el)
'lios	(en) l i  əʊ z (el)
kofte'ros	(en) k ə f t ɛ ɹ əʊ z (el)
akoni'smenos	(en) a k ə n ɪ s m i n əʊ z (el)
a'potomos	(en) a p ə t əʊ m əʊ z (el)
va'ris	(en) v a ɹ ɪ s (el)
ela'fris	(en) ɪ l a f ɹ ɪ s (el)
i'ɣros	(en) aɪ  k w əʊ t  ɡ a m ə  ɑ ɹ əʊ ɛ s (el)
kse'ros	(en) k eɪ s ɛ ɹ əʊ z (el)
ze'stos	(en) z ɛ s t əʊ z (el)
xlia'ros	(en) ɛ k s l aɪ ə ɹ əʊ z (el)
ze'stos	(en) z ɛ s t əʊ z (el)
'krios	(en) k ɹ i  əʊ z (el)
kaθa'ros	(en) k ɑ (el) θ i t a (en) a ɹ əʊ z (el)
'vromikos	(en) v i ɹ ə m ɪ k əʊ z (el)
lero'menos	(en) l ɛ ɹ ə m i n əʊ z (el)
ritiðia'smenos	(en) ɹ ɪ t ɪ ð ɪ  ɐ s m i n əʊ z (el)
psi'xi	(en) s ɪ k s i (el)
'pnefma	(en) p i n ɛ f m ə (el)
'ekpliktos	(en) ɛ k p l ɪ k t əʊ z (el)
'tixi	(en) t ɪ k s i (el)
efti'xia	(en) ɛ f t ɪ k s iə (el)
kakoti'xia	(en) k a k ə t ɪ k s iə (el)
ati'xia	(en) a t ɪ k s iə (el)
ðisti'xia	(en) ð ɪ s t ɪ k s iə (el)
xa'rumenos	(en) z a ɹ u m i n əʊ z (el)
eftixi'smenos	(en) ɛ f t ɪ k s ɪ s m i n əʊ z (el)
ɣe'lao	 (en) ɡ a m ə  i  k w əʊ t ɛ l eɪ əʊ (el)
xamoɣe'lao	(en) ɛ k s eɪ ɛ m əʊ  ɡ a m ə  i  k w əʊ t ɛ l eɪ əʊ (el)
'pezo	(en) p i z əʊ (el)
aɣa'pao	(en) eɪ  ɡ a m ə  eɪ  k w əʊ t p i  eɪ əʊ (el)
a'ɣapi	(en) eɪ  k w əʊ t  ɡ a m ə  eɪ p i  aɪ (el)
'erotas	(en) ɪ ɹ əʊ t ə z (el)
fi'lao	(en) f ɪ l aʊ (el)
aga'liazo	(en) a ɡ ɐ l ɪ  ɑ z əʊ (el)
'ponos	(en) p əʊ n əʊ z (el)
'ponos	(en) p əʊ n əʊ z (el)
kai'mos	(en) k aɪ m əʊ z (el)
aɣo'nia	(en) eɪ  ɡ a m ə  əʊ  k w əʊ t ɛ n aɪ eɪ (el)
anisi'xia	(en) a n ɪ s ɪ k s iə (el)
li'pame	(en) l ɪ p eɪ m (el)
meta'niono	(en) m ɛ t ə n iə n əʊ (el)
'iktos	(en) ɪ k t əʊ z (el)
si'bonia	(en) s ɪ b əʊ n iə (el)
'kleo	(en) k l i  əʊ (el)
ða'krizo	(en) ð a k ɹ ɪ z əʊ (el)
'ðakri	(en) ð a k ɹ i (el)
grini'azo	(en) ɡ ɹ ɪ n ɪ  ɑ z əʊ (el)
mi'so	(en) m ɪ s əʊ (el)
θi'mos	θ i t a (en) aɪ m əʊ z (el)
or'ɣi	(en) əʊ ɑ  k w əʊ t  ɡ a m ə  aɪ (el)
'zilia	(en) z ɪ l i  ə (el)
'fθonos	(en) ɛ f (el) θ i t a (en) əʊ n əʊ z (el)
dro'pi	(en) d ɹ ɒ p i (el)
(i)pe'rifanos	  (en) aɪ (el)   (en) p ɛ ɹ ɪ f ɑ n əʊ z (el)
tol'mao	(en) t ɒ l m aʊ (el)
θara'leos	θ i t a (en) a ɹ ɐ l ɪ  əʊ z (el)
tolmi'ros	(en) t ə l m ɪ ɹ əʊ z (el)
'fovos	(en) f əʊ v əʊ z (el)
'kinðinos	(en) k ɪ n ð i n əʊ z (el)
'θelo	θ i t a (en) ɪ l əʊ (el)
epiθi'mo	(en) ɛ p ɪ (el) θ i t a (en) aɪ m əʊ (el)
epi'leɣo	(en) i p i  aɪ  k w əʊ t ɛ l i  ɡ a m ə  əʊ (el)
ðia'leɣo	(en) ɛ ð aɪ eɪ  k w əʊ t ɛ l i  ɡ a m ə  əʊ (el)
el'piða	(en) ɛ l p ɪ ð ə (el)
pi'stos	(en) p ɪ s t əʊ z (el)
aliθi'nos	(en) ɑ l i (el) θ i t a (en) aɪ n əʊ z (el)
'psevðome	(en) s ɛ v ð əʊ m (el)
a'pati	(en) a p ɑ t i (el)
sinxo'ro	(en) s ɪ ŋ k s ɒ ɹ əʊ (el)
ka'los	(en) k a l əʊ z (el)
ka'kos	(en) k a k əʊ z (el)
'ðikeos	(en) ð aɪ k ɪ  əʊ z (el)
so'stos	(en) s ɒ s t əʊ z (el)
'laθos	(en) l a (el) θ i t a (en) əʊ ɛ s (el)
'laθos	(en) l a (el) θ i t a (en) əʊ ɛ s (el)
'sfalma	(en) ɛ s f a l m ə (el)
mom'fi	(en) m ɒ m f i (el)
e'gomio	(en) ɛ ɡ əʊ m ɪ  əʊ (el)
'epenos	(en) ɛ p i n əʊ z (el)
o'reos	(en) əʊ ɹ ɪ  əʊ z (el)
'omorfos	(en) ɒ m ɔ f əʊ z (el)
'asximos	(en) ɐ s k s ɪ m əʊ z (el)
a'xortaɣos	(en) eɪ  k w əʊ t ɛ k s əʊ ɑ t i  eɪ  ɡ a m ə  əʊ ɛ s (el)
'aplistos	(en) ɐ p l ɪ s t əʊ z (el)
'lemarɣos	(en) ɛ l i  ɛ m eɪ ɑ  ɡ a m ə  əʊ ɛ s (el)
'eksipnos	(en) ɛ k s ɪ p n əʊ z (el)
'efstrofos	(en) ɛ f s t ɹ əʊ f əʊ z (el)
'skepsi	(en) s k ɛ p s i (el)
'ɣnomi	(en) ɡ a m ə  n əʊ m i (el)
'skeftome	(en) s k ɛ f t əʊ m (el)
no'mizo	(en) n ə m ɪ z əʊ (el)
pi'stevo	(en) p ɪ s t i v əʊ (el)
katala'veno	(en) k a t ɐ l ɐ v i n əʊ (el)
'ksero	(en) k eɪ s iə ɹ əʊ (el)
ɣno'rizo	(en) ɡ a m ə  n ə ɹ ɪ z əʊ (el)
ma'devo	(en) m a d i v əʊ (el)
mi'mume	(en) m ɪ m j u m (el)
'fenome	(en) f ɛ n əʊ m (el)
i'ðea	(en) aɪ ð iə (el)
'enia	(en) i n i  ə (el)
so'fos	(en) s ɒ f əʊ z (el)
polima'θis	(en) p ɒ l ɪ m ɐ θ i t ə  ɪ z (el)
'vlakas	(en) v l ɑ k ə z (el)
kou'tos	(en) k u t əʊ z (el)
tre'los	(en) t ɹ ɛ l əʊ z (el)
a'noitos	(en) a n ɔɪ t əʊ z (el)
i'liθios	(en) aɪ l i (el) θ i t a (en) aɪ əʊ ɛ s (el)
ma'θeno	(en) m a θ i t ə  ɪ n əʊ (el)
spu'ðazo	(en) s p ʌ ð ɑ z əʊ (el)
mele'to	(en) m ɛ l ɛ t əʊ (el)
ði'ðasko	(en) ð ɪ ð a s k əʊ (el)
maθi'tis	(en) m ɑ (el) θ i t a (en) aɪ t i z (el)
kaθiɣi'tis	(en) k ɑ (el) θ i t a (en) aɪ ɡ a m ə  aɪ k w əʊ t t i  aɪ ɛ s (el)
sxo'lio	(en) ɛ s z ɒ l ɪ  əʊ (el)
θi'mame	θ i t a (en) aɪ m eɪ m (el)
kse'xnao	(en) k eɪ s ɛ k s n aʊ (el)
fane'ros	(en) f eɪ n ɹ əʊ z (el)
a'plos	(en) a p l əʊ z (el)
kse'kaθaros	(en) k eɪ s ɛ k ə (el) θ i t a (en) a ɹ əʊ z (el)
skoti'nos	(en) s k ə t ɪ n əʊ z (el)
ðis'noitos	(en) ð ɪ s n ɔɪ t əʊ z (el)
misti'kos	(en) m ɪ s t ɪ k əʊ z (el)
'siɣuros	(en) ɛ s aɪ  ɡ a m ə  j u ɑ ɹ əʊ ɛ s (el)
'veveos	(en) v ɛ v ɪ  əʊ z (el)
eksi'ɣo	(en) i k eɪ ɛ s aɪ  k w əʊ t  ɡ a m ə  əʊ (el)
'stoxos	(en) s t ɒ k s əʊ z (el)
sko'pos	(en) s k ɒ p əʊ z (el)
proka'lo	(en) p ɹ ə k a l əʊ (el)
amfi'valo	(en) a m f ɪ v ə l əʊ (el)
ipopsi'azome	(en) aɪ p ə p s ɪ  ɐ z əʊ m (el)
proðiðo	(en) p ɹ ə ð ɪ ð əʊ (el)
a'nagi	(en) a n ɑ ɡ ɪ (el)
'efkolos	(en) ɛ f k ɒ l əʊ z (el)
'ðiskolos	(en) ð ɪ s k ɒ l əʊ z (el)
prospa'θo	(en) p ɹ ɒ s p ɐ θ i t ə  əʊ (el)
ðoki'mazo	(en) ð ɒ k ɪ m ɑ z əʊ (el)
'tropos	(en) t ɹ əʊ p əʊ z (el)
'ke	(en) k i (el)
ɣia'ti	 (en) ɡ a m ə  aɪ eɪ  k w əʊ t t i  aɪ (el)
epi'ði	(en) ɛ p ɪ ð i (el)
ði'oti	(en) ð ɪ  əʊ t i (el)
(e)'an	  (en) i (el)   (en) ɐ n (el)
'i	(en) aɪ (el)
'ne	(en) n i (el)
katafati'kos	(en) k a t ɐ f ɐ t ɪ k əʊ z (el)
'oxi	(en) ɒ k s i (el)
arniti'kos	(en) ɑ n ɪ t ɪ k əʊ z (el)
'pos	(en) p ɒ s (el)
'posos	(en) p əʊ s əʊ z (el)
'poso	(en) p əʊ s əʊ (el)
'ti	(en) t aɪ (el)
'pote	(en) p əʊ t (el)
'pu	(en) p u (el)
pi'os	(en) p ɪ  əʊ z (el)
pi'os	(en) p ɪ  əʊ z (el)
ɣia'ti	 (en) ɡ a m ə  aɪ eɪ  k w əʊ t t i  aɪ (el)
fo'ni	(en) f ɒ n i (el)
traɣu'ðao	(en) t i  ɑ ɹ eɪ  ɡ a m ə  j u  k w əʊ t ɛ ð eɪ əʊ (el)
fo'nazo	(en) f ə n ɑ z əʊ (el)
ksefo'nizo	(en) k eɪ s ɛ f ə n ɪ z əʊ (el)
psiθi'rizo	(en) s aɪ (el) θ i t a (en) aɪ ɹ ɪ z əʊ (el)
murmu'rizo	(en) m ɜ m ə ɹ ɪ z əʊ (el)
pse'lizo	(en) s ɛ l ɪ z əʊ (el)
sfi'rizo	(en) ɛ s f ɪ ɹ ɪ z əʊ (el)
ur'liazo	(en) ʌ r l ɪ  ɑ z əʊ (el)
kra'vɣazo	(en) k eɪ ɑ ɹ eɪ  k w əʊ t v i  ɡ a m ə  eɪ z ɛ d əʊ (el)
'krazo	(en) k ɹ ɑ z əʊ (el)
mi'lao	(en) m ɪ l aʊ (el)
tra'vlizo	(en) t ɹ a v l ɪ z əʊ (el)
keke'ðizo	(en) k ɛ k ɪ ð ɪ z əʊ (el)
'leo	(en) l i  əʊ (el)
afi'ɣume	(en) eɪ ɛ f aɪ  k w əʊ t  ɡ a m ə  j u ɛ m i (el)
ðii'ɣume	(en) ɛ ð aɪ  aɪ  k w əʊ t  ɡ a m ə  j u ɛ m i (el)
'ɣlosa	(en) ɡ a m ə  l əʊ s ə (el)
'leksi	(en) l ɛ k s i (el)
'onoma	(en) ɒ n əʊ m ə (el)
ro'tao	(en) ɹ ɒ t aʊ (el)
apa'dao	(en) ɐ p a d aʊ (el)
para'ðexome	(en) p a ɹ ə ð ɛ k s əʊ m (el)
omolo'ɣo	(en) əʊ ɛ m əʊ ɛ l əʊ  k w əʊ t  ɡ a m ə  əʊ (el)
ar'nume	(en) ɑ n j u m (el)
zi'tao	(en) z ɪ t aʊ (el)
i'posxome	(en) aɪ p ɒ s k s əʊ m (el)
ar'nume	(en) ɑ n j u m (el)
apaɣo'revo	(en) eɪ p i  eɪ  ɡ a m ə  əʊ  k w əʊ t ɑ ɹ i v i  əʊ (el)
ma'lono	(en) m a l əʊ n əʊ (el)
'memfome	(en) m ɛ m f əʊ m (el)
ka'lo	(en) k a l əʊ (el)
fo'nazo	(en) f ə n ɑ z əʊ (el)
ono'mazome	(en) ɒ n ə m a z əʊ m (el)
ka'lume	(en) k a l u m (el)
ana'gelo	(en) a n ɐ dʒ i l əʊ (el)
anaki'riso	(en) a n ɐ k ɪ ɹ aɪ z əʊ (el)
api'lo	(en) ɐ p ɪ l əʊ (el)
fove'rizo	(en) f əʊ v ɹ ɪ z əʊ (el)
pe'nevome	(en) p ɛ n ɪ v əʊ m (el)
(i)perifa'nevome	  (en) aɪ (el)   (en) p ɛ ɹ ɪ f a n ɪ v əʊ m (el)
'ɣrafo	(en) ɡ a m ə  ɹ ɑ f əʊ (el)
ðia'vazo	(en) ð aɪ ə v ɑ z əʊ (el)
xar'ti	(en) z ɑ t i (el)
'pena	(en) p i n ə (el)
vi'vlio	(en) v ɪ v l ɪ  əʊ (el)
pii'tis	(en) p ɪ  ɪ t i z (el)
'flauto	(en) f l ɔ t əʊ (el)
'tibano	(en) t ɪ b ɑ n əʊ (el)
ta'burlo	(en) t a b ɜ l əʊ (el)
tro'beta	(en) t ɹ ɒ b ɛ t ə (el)
kuðu'nistra	(en) k j u ð ə n ɪ s t ɹ ə (el)
'xora	(en) z ɔ ɹ ə (el)
pa'triða	(en) p a t ɹ ɪ ð ə (el)
'poli	(en) p əʊ l i (el)
xori'o	(en) z ɔ ɹ ɪ  əʊ (el)
'sinoro	(en) s ɪ n ɔ ɹ əʊ (el)
'orio	(en) ɔ ɹ ɪ  əʊ (el)
la'os	(en) l a əʊ z (el)
fi'li	(en) f ɪ l i (el)
'fara	(en) f ɑ ɹ ə (el)
'klika	(en) k l i k ə (el)
arxi'ɣos	(en) eɪ ɑ ɹ ɛ k s aɪ  k w əʊ t  ɡ a m ə  əʊ ɛ s (el)
ba'stuni	(en) b a s t u n i (el)
ma'gura	(en) m a ɡ j ʊə ɹ ə (el)
vasi'levo	(en) v a s ɪ l i v əʊ (el)
kiver'no	(en) k aɪ v r n əʊ (el)
vasi'lias	(en) v a s ɪ l iə z (el)
kiver'nitis	(en) k aɪ v r n aɪ t ɪ s (el)
va'silisa	(en) v a s ɪ l ɪ s ə (el)
evɣe'nis	(en) i v i  ɡ a m ə  i  k w əʊ t ɛ n aɪ ɛ s (el)
po'litis	(en) p ə l aɪ t ɪ s (el)
i'pikoos	(en) aɪ p ɪ k u z (el)
'kirios	(en) k ɪ ɹ ɪ  əʊ z (el)
a'fedis	(en) a f ɛ d ɪ z (el)
'sklavos	(en) s k l ɑ v əʊ z (el)
ipi'retis	(en) ɪ p ɪ ɹ ɛ t i z (el)
ðia'tazo	(en) ð aɪ ə t ɑ z əʊ (el)
pro'stazo	(en) p ɹ ə s t ɑ z əʊ (el)
ipa'kuo	(en) ɪ p ɐ k j u əʊ (el)
epi'trepo	(en) ɛ p ɪ t ɹ i p əʊ (el)
a'fino	(en) a f i n əʊ (el)
'filos	(en) f aɪ l əʊ z (el)
'sidrofos	(en) s ɪ d ɹ əʊ f əʊ z (el)
ex'θros	(en) ɛ k s θ i t ə  ɹ əʊ z (el)
'ɣitonas	 (en) ɡ a m ə  aɪ t i  əʊ ɛ n eɪ ɛ s (el)
'ksenos	(en) k eɪ s i n əʊ z (el)
kale'smenos	(en) k eɪ l s m i n əʊ z (el)
proskekli'menos	(en) p ɹ ɒ s k ɪ k l ɪ m i n əʊ z (el)
ikoðe'spotis	(en) aɪ k əʊ ð s p əʊ t i z (el)
voi'θo	(en) v ɔɪ θ i t ə  əʊ (el)
ebo'ðizo	(en) ɛ b ə ð ɪ z əʊ (el)
apo'trepo	(en) ɐ p ə t ɹ i p əʊ (el)
'eθimo	(en) i (el) θ i t a (en) aɪ ɛ m əʊ (el)
'pali	(en) p ɑ l i (el)
ka'vɣas	(en) k eɪ eɪ  k w əʊ t v i  ɡ a m ə  eɪ ɛ s (el)
sinomo'sia	(en) s ɪ n ə m ɒ z iə (el)
sina'do	(en) s ɪ n a d əʊ (el)
'porni	(en) p ɔ n i (el)
aɣo'nizome	(en) eɪ  ɡ a m ə  əʊ  k w əʊ t ɛ n aɪ z ɛ d əʊ ɛ m i (el)
pole'mo	(en) p əʊ l m əʊ (el)
'maxome	(en) m a k s əʊ m (el)
'polemos	(en) p ɒ l i m əʊ z (el)
'maxi	(en) m a k s i (el)
i'rini	(en) aɪ ɹ i n ɪ (el)
stra'tos	(en) s t ɹ a t əʊ z (el)
strati'otis	(en) s t ɹ a t ɪ  əʊ t i z (el)
'opla	(en) ɒ p l ə (el)
'ropalo	(en) ɹ əʊ p ə l əʊ (el)
'klob	(en) k l ɒ b (el)
'pelekis	(en) p ɛ l ɪ k i z (el)
sfe'dona	(en) ɛ s f ɛ d əʊ n ə (el)
'tokso	(en) t ɒ k s əʊ (el)
'velos	(en) v i l əʊ z (el)
'lonxi	(en) l ɒ ŋ k s i (el)
'ðori	(en) ð ɔ ɹ i (el)
a'kodio	(en) a k əʊ d ɪ  əʊ (el)
spa'θi	(en) s p a θ i t ə  aɪ (el)
'oplo	(en) ɒ p l əʊ (el)
tu'feki	(en) t ʌ f ɪ k i (el)
ka'noni	(en) k a n əʊ n i (el)
pano'plia	(en) p a n ɒ p l iə (el)
'kranos	(en) k ɹ ɑ n əʊ z (el)
a'spiða	(en) a s p ɪ ð ə (el)
'frurio	(en) f ɹ ʊə ɹ ɪ  əʊ (el)
'pirɣos	(en) p i  aɪ  ɑ  ɡ a m ə  əʊ ɛ s (el)
'niki	(en) n ɪ k i (el)
'ita	(en) i t ə (el)
epi'tiθeme	(en) ɛ p ɪ t i (el) θ i t a (en) ɪ m ɛ (el)
a'minome	(en) a m ɪ n əʊ m eɪ (el)
ipoxo'ro	(en) aɪ p ə k s ɒ ɹ əʊ (el)
para'ðinome	(en) p a ɹ ə ð ɪ n əʊ m eɪ (el)
ex'malotos	(en) ɛ k s m ɐ l əʊ t əʊ z (el)
fru'ros	(en) f ɹ ʌ ɹ əʊ z (el)
sko'pos	(en) s k ɒ p əʊ z (el)
'lafiro	(en) l a f iə ɹ əʊ (el)
e'neðra	(en) ɛ n ɛ ð ɹ ə (el)
psa'ras	(en) s a ɹ ə z (el)
a'gistri	(en) a dʒ ɪ s t ɹ i (el)
'ðixti	(en) ð ɪ k s t i (el)
psaro'kalaθo	(en) s a ɹ ə k ɑ l ə (el) θ i t a (en) əʊ (el)
psaropa'ɣiða	(en) p i  ɛ s eɪ ɑ ɹ əʊ p i  eɪ  k w əʊ t  ɡ a m ə  aɪ ɛ ð eɪ (el)
'ðoloma	(en) ð ə l əʊ m ə (el)
kini'ɣao	(en) k eɪ aɪ ɛ n aɪ  k w əʊ t  ɡ a m ə  eɪ əʊ (el)
pirovo'lo	(en) p ɪ ɹ ə v ɒ l əʊ (el)
tufe'kizo	(en) t j u f ɪ k ɪ z əʊ (el)
asto'xo	(en) ɐ s t ɒ k s əʊ (el)
pa'ɣiða	(en) p i  eɪ  k w əʊ t  ɡ a m ə  aɪ ɛ ð eɪ (el)
paɣi'ðevo	(en) p i  eɪ  ɡ a m ə  aɪ  k w əʊ t ɛ ð i v i  əʊ (el)
'nomos	(en) n əʊ m əʊ z (el)
'ðikeo	(en) ð aɪ k ɪ  əʊ (el)
ðika'stirio	(en) ð ɪ k ɐ s t ɪ ɹ ɪ  əʊ (el)
ði'kazo	(en) ð ɪ k ɑ z əʊ (el)
ðika'stis	(en) ð ɪ k ɐ s t i z (el)
ka'tiɣoros	(en) k eɪ eɪ  k w əʊ t t i  aɪ  ɡ a m ə  əʊ ɑ ɹ əʊ ɛ s (el)
e'naɣon	(en) i  k w əʊ t ɛ n eɪ  ɡ a m ə  əʊ ɛ n (el)
katiɣo'rumenos	(en) k eɪ eɪ t i  aɪ  ɡ a m ə  əʊ  k w əʊ t ɑ j u ɛ m i  ɛ n əʊ ɛ s (el)
ena'ɣomenos	(en) i  ɛ n eɪ  k w əʊ t  ɡ a m ə  əʊ ɛ m i  ɛ n əʊ ɛ s (el)
'martiras	(en) m ɑ t iə ɹ ə z (el)
or'kizome	(en) ɔ k ɪ z əʊ m (el)
'orkos	(en) ɔ k əʊ z (el)
katiɣo'ro	(en) k eɪ eɪ t i  aɪ  ɡ a m ə  əʊ  k w əʊ t ɑ ɹ əʊ (el)
kataði'kazo	(en) k a t ɐ ð ɪ k ɑ z əʊ (el)
aθo'ono	(en) eɪ (el) θ i t a (en) əʊ əʊ n əʊ (el)
apa'laso	(en) ɐ p ɐ l ɑ s əʊ (el)
'enoxos	(en) ɪ n ɒ k s əʊ z (el)
a'θoos	(en) a θ i t ə  u z (el)
timo'ria	(en) t ɪ m ɒ ɹ iə (el)
pi'ni	(en) p ɪ n i (el)
'prostimo	(en) p ɹ ə s t ɪ m əʊ (el)
fila'ki	(en) f ɪ l ɐ k i (el)
'fonos	(en) f əʊ n əʊ z (el)
ðolofo'nia	(en) ð ɒ l ə f ɒ n iə (el)
mi'xia	(en) m ɪ k s i  ə (el)
via'smos	(en) v aɪ ə s m əʊ z (el)
embri'smos	(en) ɛ m b ɹ ɪ s m əʊ z (el)
psevðor'kia	(en) s ɛ v ð ɔ k iə (el)
epior'kia	(en) ɛ p ɪ  ɔ k iə (el)
'klevo	(en) k l i v əʊ (el)
'kleftis	(en) k l ɛ f t i z (el)
θri'skia	θ i t a (en) ɹ ɪ s k i  ə (el)
θe'os	θ i t a (en) ɛ əʊ z (el)
na'os	(en) n a əʊ z (el)
ekli'sia	(en) ɛ k l ɪ z iə (el)
θi'sia	θ i t a (en) aɪ z iə (el)
prosfo'ra	(en) p ɹ ɒ s f ɒ ɹ ə (el)
la'trevo	(en) l a t ɹ i v əʊ (el)
pro'sefxome	(en) p ɹ ɒ s ɪ f k s əʊ m (el)
pa'pas	(en) p a p ə z (el)
ie'reas	(en) i ɹ iə z (el)
iero'menos	(en) iə ɹ ə m i n əʊ z (el)
ie'ros	(en) i ɹ əʊ z (el)
'aɣios	(en) eɪ  ɡ a m ə  aɪ əʊ ɛ s (el)
ki'rito	(en) k ɪ ɹ i t əʊ (el)
evlo'ɣo	(en) i v i  ɛ l əʊ  k w əʊ t  ɡ a m ə  əʊ (el)
kata'rieme	(en) k a t ɐ ɹ ɪ m (el)
anaθema'tizo	(en) ɑ n ə (el) θ i t a (en) ɪ m ɐ t ɪ z əʊ (el)
ni'stevo	(en) n ɪ s t i v əʊ (el)
ura'nos	(en) j ʊə ɹ a n əʊ z (el)
pa'raðisos	(en) p a ɹ ɐ ð aɪ z əʊ z (el)
'kolasi	(en) k ɒ l ɐ s i (el)
'ðemonas	(en) ð ɛ m əʊ n ə z (el)
'ðiavolos	(en) ð aɪ ə v ɒ l əʊ z (el)
sata'nas	(en) s a t a n ə z (el)
'iðolo	(en) aɪ ð ɒ l əʊ (el)
ma'ɣia	(en) ɛ m eɪ  k w əʊ t  ɡ a m ə  aɪ eɪ (el)
'maɣia	(en) ɛ m eɪ  ɡ a m ə  aɪ eɪ (el)
'maɣos	(en) ɛ m eɪ  ɡ a m ə  əʊ ɛ s (el)
'maɣisa	(en) ɛ m eɪ  ɡ a m ə  aɪ ɛ s eɪ (el)
ne'raiða	(en) n ɛ ɹ eɪ ð ə (el)
ksoti'ko	(en) k eɪ s əʊ t ɪ k əʊ (el)
'fadasma	(en) f a d a z m ə (el)
'pnefma	(en) p i n ɛ f m ə (el)
vri'kolakas	(en) v i ɹ ɪ k ə l ɑ k ə z (el)
pro'minima	(en) p ɹ ɒ m ɪ n ɪ m ə (el)
io'nos	(en) aɪ ɒ n əʊ z (el)
